customer_id,recency,frequency,monetary,customer_name,R_score,F_score,M_score,RFM_score,segment
1,16,5,7031.01,João Guilherme da Cruz,4,3,3,10,VIP
2,12,5,3586.5099999999998,Henrique da Conceição,4,3,2,9,Regular
3,29,7,6507.24,Emanuel Sampaio,3,4,3,10,VIP
4,80,4,2803.53,Aylla Fogaça,2,2,2,6,Ocasional
5,33,8,4573.63,Maria Cecília Oliveira,3,4,3,10,VIP
6,52,3,1039.97,Carlos Eduardo Garcia,2,1,1,4,Ocasional
7,8,4,1964.8300000000002,Ana Sophia Pereira,4,2,1,7,Regular
8,132,4,10239.58,Hellena Rodrigues,1,2,4,7,Regular
9,32,4,2462.67,Luara Cunha,3,2,2,7,Regular
10,49,2,7522.46,Zoe da Luz,2,1,4,7,Regular
11,130,5,7482.3099999999995,Daniel Cassiano,1,3,4,8,Regular
12,12,8,12517.35,Alexia Rodrigues,4,4,4,12,VIP
13,7,5,5957.68,João Montenegro,4,3,3,10,VIP
14,6,5,9911.470000000001,Sr. Vitor Hugo Vasconcelos,4,3,4,11,VIP
15,17,6,3376.52,Isaque Araújo,4,3,2,9,Regular
16,47,3,2206.1800000000003,Renan Novaes,2,1,1,4,Ocasional
17,136,2,3144.77,Leonardo Guerra,1,1,2,4,Ocasional
18,138,1,394.5,Heloísa Pastor,1,1,1,3,Inativo
19,12,2,2513.8700000000003,Sr. Théo da Costa,4,1,2,7,Regular
20,28,7,3854.32,Calebe Brito,3,4,2,9,Regular
21,11,7,9498.050000000001,Beatriz Araújo,4,4,4,12,VIP
22,103,1,20.69,Otávio Cirino,1,1,1,3,Inativo
24,209,3,958.21,Mathias da Luz,1,1,1,3,Inativo
25,46,5,9228.56,Vitor Hugo Araújo,2,3,4,9,Regular
26,17,3,2283.43,Bernardo Peixoto,4,1,2,7,Regular
27,151,1,328.5,Bruno Leão,1,1,1,3,Inativo
28,36,3,4832.58,Luara Sá,3,1,3,7,Regular
29,256,2,2813.0099999999998,Davi Lucca Ferreira,1,1,2,4,Ocasional
30,73,5,4331.01,Vinícius Albuquerque,2,3,2,7,Regular
31,26,5,2257.13,Gustavo Henrique Silva,3,3,1,7,Regular
32,7,7,7283.500000000001,Augusto Abreu,4,4,3,11,VIP
33,9,9,5777.39,Breno Sales,4,4,3,11,VIP
34,6,10,6726.599999999999,Sr. Luiz Henrique Costela,4,4,3,11,VIP
35,29,8,7243.43,Noah Alves,3,4,3,10,VIP
36,250,3,4414.44,Mateus Andrade,1,1,3,5,Ocasional
37,75,2,470.52,Murilo Farias,2,1,1,4,Ocasional
38,80,1,105.56,José Pedro Cavalcanti,2,1,1,4,Ocasional
39,281,1,1401.65,Bruna Gomes,1,1,1,3,Inativo
40,39,3,1256.67,Dra. Fernanda Fonseca,3,1,1,5,Ocasional
41,61,3,3825.25,Luana Rios,2,1,2,5,Ocasional
42,9,5,6099.950000000001,Emanuella Pimenta,4,3,3,10,VIP
43,111,4,2456.5,Luna Martins,1,2,2,5,Ocasional
44,26,8,8273.97,João Miguel Moraes,3,4,4,11,VIP
45,140,3,1888.1299999999999,Ana Sophia Marques,1,1,1,3,Inativo
46,103,7,7142.15,Srta. Bianca Vasconcelos,1,4,3,8,Regular
47,34,4,3565.8599999999997,Rafael Carvalho,3,2,2,7,Regular
48,49,2,1812.2199999999998,Mariane Novaes,2,1,1,4,Ocasional
49,251,2,2275.38,Vicente Mendonça,1,1,2,4,Ocasional
50,127,3,4330.62,Anna Liz Carvalho,1,1,2,4,Ocasional
51,28,5,8771.48,Luísa Nogueira,3,3,4,10,VIP
52,45,1,591.02,Maria Helena Mendes,2,1,1,4,Ocasional
53,45,7,11460.07,Ryan Câmara,2,4,4,10,VIP
54,25,6,4565.97,Carolina Pinto,3,3,3,9,Regular
55,24,6,9815.72,Lunna Cunha,3,3,4,10,VIP
57,12,6,5093.65,Josué Costa,4,3,3,10,VIP
58,3,6,11605.02,Ravi Lucca Sampaio,4,3,4,11,VIP
59,87,5,4998.62,Cauê Pacheco,2,3,3,8,Regular
60,64,7,4727.65,Isabelly Caldeira,2,4,3,9,Regular
61,24,6,8329.2,Sr. Otto Mendonça,3,3,4,10,VIP
62,47,4,9711.18,Júlia Pimenta,2,2,4,8,Regular
63,29,4,5532.629999999999,Rael da Cruz,3,2,3,8,Regular
64,58,2,1159.22,Ryan Cunha,2,1,1,4,Ocasional
65,136,4,2701.4100000000003,Isaque Silveira,1,2,2,5,Ocasional
66,45,4,4621.42,Caleb da Rocha,2,2,3,7,Regular
67,48,5,8556.05,Manuella Lima,2,3,4,9,Regular
68,13,4,3040.49,Vitor Gabriel Teixeira,4,2,2,8,Regular
69,41,1,259.99,Larissa Brito,3,1,1,5,Ocasional
70,236,4,3460.3199999999997,João Guilherme Aparecida,1,2,2,5,Ocasional
71,46,4,7279.96,João Miguel Melo,2,2,3,7,Regular
72,101,4,5502.530000000001,Murilo Mendonça,1,2,3,6,Ocasional
73,21,7,3521.34,Dante Novais,3,4,2,9,Regular
74,14,5,1489.85,Letícia Pastor,4,3,1,8,Regular
75,27,10,7572.94,Heitor da Luz,3,4,4,11,VIP
76,49,3,4916.52,Dra. Olivia da Rocha,2,1,3,6,Ocasional
77,10,5,9250.33,Gael Henrique Lima,4,3,4,11,VIP
78,175,1,4207.72,Enzo Vieira,1,1,2,4,Ocasional
79,197,3,5394.27,Maysa Barros,1,1,3,5,Ocasional
80,26,4,1255.0,Alícia Teixeira,3,2,1,6,Ocasional
81,27,5,7505.719999999999,Ayla Melo,3,3,4,10,VIP
82,27,6,2622.4,Laura Ribeiro,3,3,2,8,Regular
83,20,5,3392.46,Sophie Abreu,3,3,2,8,Regular
84,78,2,2288.62,Gustavo da Mata,2,1,2,5,Ocasional
85,1,8,14512.019999999999,Emanuel das Neves,4,4,4,12,VIP
86,33,5,8301.51,Daniela Monteiro,3,3,4,10,VIP
87,358,1,2743.72,Thomas Souza,1,1,2,4,Ocasional
88,130,3,4254.85,Kaique Pastor,1,1,2,4,Ocasional
90,208,3,6774.54,Sra. Maria Helena Gomes,1,1,3,5,Ocasional
91,36,6,4990.29,Alice Silveira,3,3,3,9,Regular
92,27,4,10935.119999999999,Dr. Bruno Farias,3,2,4,9,Regular
93,12,4,5727.78,Laura da Conceição,4,2,3,9,Regular
94,16,7,7016.02,Augusto Duarte,4,4,3,11,VIP
95,67,3,1824.8000000000002,Emilly Cavalcante,2,1,1,4,Ocasional
96,7,6,9659.94,Jade Marques,4,3,4,11,VIP
97,48,4,7410.259999999999,Letícia Porto,2,2,4,8,Regular
98,14,3,2413.08,Maria Alice Oliveira,4,1,2,7,Regular
99,66,1,1608.37,Theo da Paz,2,1,1,4,Ocasional
100,16,8,13597.15,Dra. Cecilia Pires,4,4,4,12,VIP
101,39,4,3640.41,Juan Duarte,3,2,2,7,Regular
102,168,3,2758.87,Rodrigo da Rocha,1,1,2,4,Ocasional
103,14,3,7405.86,Maria Clara Borges,4,1,4,9,Regular
104,22,4,3660.2799999999997,Julia Pacheco,3,2,2,7,Regular
105,1,3,2455.0,Lunna Pimenta,4,1,2,7,Regular
106,43,3,1374.1200000000001,Kevin Monteiro,3,1,1,5,Ocasional
107,17,6,7614.5599999999995,Dra. Ágatha Leão,4,3,4,11,VIP
108,186,2,1760.12,Sr. Pedro Miguel Macedo,1,1,1,3,Inativo
109,49,5,4576.26,Davi Marques,2,3,3,8,Regular
110,34,5,2463.88,Gustavo Azevedo,3,3,2,8,Regular
111,50,7,10693.66,Davi Lucca Nogueira,2,4,4,10,VIP
112,115,4,8989.640000000001,Luna Almeida,1,2,4,7,Regular
113,8,7,13964.699999999999,Maria Cecília Moraes,4,4,4,12,VIP
114,39,4,3457.93,Stephany da Rosa,3,2,2,7,Regular
115,3,5,5207.75,Sra. Ana Sophia Barros,4,3,3,10,VIP
116,15,7,10587.25,Marina Brito,4,4,4,12,VIP
117,21,5,12508.99,Maria Vitória Siqueira,3,3,4,10,VIP
118,55,5,2304.4300000000003,Caleb Barros,2,3,2,7,Regular
119,36,8,6456.44,Luísa Rios,3,4,3,10,VIP
120,81,2,2931.72,Sr. Thiago Cunha,2,1,2,5,Ocasional
121,56,5,10431.52,Heloisa Lima,2,3,4,9,Regular
122,24,5,4240.74,Dr. André Cirino,3,3,2,8,Regular
123,109,4,13227.66,Mariah Marques,1,2,4,7,Regular
124,85,1,19.27,Eduardo Castro,2,1,1,4,Ocasional
125,49,3,4162.37,Júlia Cunha,2,1,2,5,Ocasional
126,362,1,894.2,Augusto Câmara,1,1,1,3,Inativo
127,61,2,871.6700000000001,João Vitor Duarte,2,1,1,4,Ocasional
128,33,9,10034.61,Theodoro Novais,3,4,4,11,VIP
129,91,4,5207.32,Mariane Oliveira,1,2,3,6,Ocasional
130,48,10,8376.75,Raul Sales,2,4,4,10,VIP
131,8,8,27037.620000000003,Lucca Câmara,4,4,4,12,VIP
132,42,10,5844.0599999999995,Dr. Diogo da Costa,3,4,3,10,VIP
133,180,6,3247.04,Ana Vitória Cavalcanti,1,3,2,6,Ocasional
134,165,1,3793.24,Luna Pires,1,1,2,4,Ocasional
135,17,4,7665.47,Luiz Gustavo Montenegro,4,2,4,10,VIP
136,15,8,7488.34,Caleb Pimenta,4,4,4,12,VIP
137,11,4,1995.83,Lorenzo Pereira,4,2,1,7,Regular
138,87,7,9046.77,Emanuella Aparecida,2,4,4,10,VIP
139,13,4,9001.85,Maria Luísa Vasconcelos,4,2,4,10,VIP
140,38,4,3341.64,Dom Farias,3,2,2,7,Regular
141,1,2,6019.5599999999995,Leonardo Novais,4,1,3,8,Regular
142,75,3,1495.7199999999998,Dra. Valentina Borges,2,1,1,4,Ocasional
143,17,6,7449.94,Evelyn Câmara,4,3,4,11,VIP
144,95,6,12244.48,Dra. Ana Carolina Ribeiro,1,3,4,8,Regular
145,6,3,786.73,Eloah Silveira,4,1,1,6,Ocasional
146,15,4,4094.96,Sra. Isabel Nascimento,4,2,2,8,Regular
147,37,4,4010.25,Nicole Vargas,3,2,2,7,Regular
148,97,4,11583.810000000001,Benjamim Ramos,1,2,4,7,Regular
149,73,5,3400.16,Rael Moraes,2,3,2,7,Regular
150,48,8,11449.61,Maria Fernanda da Costa,2,4,4,10,VIP
151,22,3,4472.15,Lívia Vieira,3,1,3,7,Regular
152,22,5,3921.7299999999996,Alana Barros,3,3,2,8,Regular
153,3,8,10822.31,Isaque Leão,4,4,4,12,VIP
154,118,2,2631.55,Srta. Lavínia Lima,1,1,2,4,Ocasional
155,72,5,3087.66,Vinicius Nogueira,2,3,2,7,Regular
156,7,2,2618.7699999999995,Luiz Felipe da Costa,4,1,2,7,Regular
157,33,5,9184.880000000001,Emanuella Vasconcelos,3,3,4,10,VIP
158,53,7,5934.15,Ana Carolina da Rocha,2,4,3,9,Regular
159,38,4,5267.71,Olívia da Cunha,3,2,3,8,Regular
160,40,7,5680.14,Léo Lopes,3,4,3,10,VIP
161,130,2,314.79,Juliana Barros,1,1,1,3,Inativo
162,24,3,2951.97,Luan Ribeiro,3,1,2,6,Ocasional
163,22,8,11284.43,Sra. Maya da Mota,3,4,4,11,VIP
164,13,5,3077.24,Maysa Andrade,4,3,2,9,Regular
165,74,1,2587.9,Rael Freitas,2,1,2,5,Ocasional
166,306,1,683.8,Apollo Sousa,1,1,1,3,Inativo
167,8,4,3633.9700000000003,Hadassa Pimenta,4,2,2,8,Regular
168,86,3,3011.16,Aurora Rodrigues,2,1,2,5,Ocasional
169,14,4,3821.79,Dra. Emanuella Vieira,4,2,2,8,Regular
170,10,5,2109.38,Dr. Ravi Lucca Novaes,4,3,1,8,Regular
171,15,8,9557.24,Ana Sophia Cardoso,4,4,4,12,VIP
172,14,7,3189.6000000000004,Pedro Montenegro,4,4,2,10,VIP
173,2,8,12119.75,Luiz Felipe Moreira,4,4,4,12,VIP
174,14,5,1985.23,Eloá Pastor,4,3,1,8,Regular
175,12,4,2956.5699999999997,Augusto Ramos,4,2,2,8,Regular
176,8,4,12050.41,Liz Mendes,4,2,4,10,VIP
177,7,7,12140.789999999999,Rafaela Martins,4,4,4,12,VIP
178,54,1,2593.18,Dr. Davi Lucca Teixeira,2,1,2,5,Ocasional
179,270,1,1251.74,Diego Brito,1,1,1,3,Inativo
180,59,2,3019.69,Luara Correia,2,1,2,5,Ocasional
181,39,4,2428.35,Sofia Marques,3,2,2,7,Regular
182,28,5,9909.43,Olivia da Paz,3,3,4,10,VIP
183,18,5,4549.12,Murilo Aragão,4,3,3,10,VIP
184,345,1,2930.72,Lara Pinto,1,1,2,4,Ocasional
185,53,5,2698.55,Gael Henrique Pereira,2,3,2,7,Regular
186,246,1,699.78,Stella Marques,1,1,1,3,Inativo
187,314,1,2693.73,Lucca Montenegro,1,1,2,4,Ocasional
188,27,5,4111.96,Lorena Vieira,3,3,2,8,Regular
189,12,8,10958.93,Vinicius Pires,4,4,4,12,VIP
190,150,4,2246.56,Pedro Lucas Dias,1,2,1,4,Ocasional
191,333,1,2764.08,Ana Liz Santos,1,1,2,4,Ocasional
192,240,3,1033.4,Raul Nascimento,1,1,1,3,Inativo
193,44,2,1628.8600000000001,Kaique Vargas,2,1,1,4,Ocasional
194,21,4,6955.219999999999,Ísis Garcia,3,2,3,8,Regular
195,195,3,1621.02,Jade Souza,1,1,1,3,Inativo
196,62,4,7324.139999999999,Dra. Isabella da Cruz,2,2,4,8,Regular
197,225,4,4392.47,Sra. Beatriz Rodrigues,1,2,3,6,Ocasional
198,40,6,12148.26,Lorenzo da Paz,3,3,4,10,VIP
199,55,2,2196.77,Erick Leão,2,1,1,4,Ocasional
200,230,1,1096.91,Kaique Nunes,1,1,1,3,Inativo
201,6,3,2396.2400000000002,Lucas Castro,4,1,2,7,Regular
202,4,8,13488.17,Gael Cavalcanti,4,4,4,12,VIP
203,4,2,1445.52,Rhavi Duarte,4,1,1,6,Ocasional
204,44,1,35.62,Dr. Anthony da Luz,2,1,1,4,Ocasional
205,49,2,594.62,Sra. Bárbara Porto,2,1,1,4,Ocasional
206,17,5,3000.78,Maria Fernanda Leão,4,3,2,9,Regular
207,40,6,10965.08,Anna Liz Moura,3,3,4,10,VIP
208,18,7,10709.83,Sofia Costa,4,4,4,12,VIP
209,36,4,5973.31,Ayla Moraes,3,2,3,8,Regular
210,57,5,5743.540000000001,Lorena Silveira,2,3,3,8,Regular
211,31,4,6394.16,Sr. Vitor Hugo Araújo,3,2,3,8,Regular
212,40,2,4897.1,Dra. Mariah Freitas,3,1,3,7,Regular
213,11,6,10748.45,Luiz Fernando Campos,4,3,4,11,VIP
214,5,4,943.82,Kaique Martins,4,2,1,7,Regular
215,66,4,1425.04,Daniel Andrade,2,2,1,5,Ocasional
216,273,2,385.95000000000005,Pietro Peixoto,1,1,1,3,Inativo
217,58,8,16739.9,Davi Miguel Montenegro,2,4,4,10,VIP
218,1,11,13370.35,Hellena Jesus,4,4,4,12,VIP
219,106,2,3393.04,Ana Julia Ferreira,1,1,2,4,Ocasional
220,67,2,3161.3399999999997,Olívia da Costa,2,1,2,5,Ocasional
221,25,4,5962.66,Vitória Carvalho,3,2,3,8,Regular
222,24,3,6207.620000000001,Vitor Gabriel Silveira,3,1,3,7,Regular
223,118,3,1587.69,Helena Mendes,1,1,1,3,Inativo
224,36,5,2976.62,Isabelly Sampaio,3,3,2,8,Regular
225,24,3,1136.9,Maria Alice das Neves,3,1,1,5,Ocasional
226,35,5,8136.540000000001,Sr. Léo Dias,3,3,4,10,VIP
227,61,5,3384.15,Maria Vitória da Rocha,2,3,2,7,Regular
228,19,5,8665.22,Maitê da Cunha,4,3,4,11,VIP
229,108,2,990.09,Davi Miguel Silveira,1,1,1,3,Inativo
230,23,4,3804.3199999999997,Benicio Teixeira,3,2,2,7,Regular
231,174,2,3750.09,Thiago Marques,1,1,2,4,Ocasional
232,20,5,7781.369999999999,Antony Moura,3,3,4,10,VIP
233,28,7,2954.34,Gael Pinto,3,4,2,9,Regular
234,29,8,10240.619999999999,Srta. Letícia Rodrigues,3,4,4,11,VIP
235,2,6,2398.46,Alexia Sampaio,4,3,2,9,Regular
236,48,3,5033.4,Heitor Sales,2,1,3,6,Ocasional
237,2,4,8985.59,Sr. Gustavo Henrique Pastor,4,2,4,10,VIP
238,40,2,3552.69,Ágatha Farias,3,1,2,6,Ocasional
239,28,7,7105.049999999999,Carlos Eduardo Lopes,3,4,3,10,VIP
240,58,2,1885.6899999999998,Rebeca da Conceição,2,1,1,4,Ocasional
241,16,6,5482.36,Bryan da Mata,4,3,3,10,VIP
242,36,3,822.1800000000001,Caleb Abreu,3,1,1,5,Ocasional
243,14,6,20825.64,Sophie Jesus,4,3,4,11,VIP
244,14,9,15210.88,Alice da Rocha,4,4,4,12,VIP
245,178,5,2569.58,Eloá Carvalho,1,3,2,6,Ocasional
246,48,4,3901.8900000000003,Rodrigo Viana,2,2,2,6,Ocasional
247,195,3,6851.920000000001,Kevin Abreu,1,1,3,5,Ocasional
248,217,3,5692.95,Catarina da Rosa,1,1,3,5,Ocasional
249,28,2,497.88,Isabelly Duarte,3,1,1,5,Ocasional
250,195,3,1730.04,Emilly Rodrigues,1,1,1,3,Inativo
251,35,6,10032.08,Srta. Maria Luísa Rocha,3,3,4,10,VIP
252,88,3,2088.84,Maria Flor Barbosa,1,1,1,3,Inativo
253,13,5,6866.9800000000005,Luiz Miguel Sampaio,4,3,3,10,VIP
254,6,5,10877.22,Maria Liz Sá,4,3,4,11,VIP
255,51,3,5413.39,Hellena Machado,2,1,3,6,Ocasional
256,125,3,1141.54,Oliver Barros,1,1,1,3,Inativo
257,48,2,344.26,Marcela Melo,2,1,1,4,Ocasional
258,24,11,10646.09,Antônio Fernandes,3,4,4,11,VIP
259,132,3,1223.88,Dr. Ravi da Conceição,1,1,1,3,Inativo
260,149,3,1846.84,Rael Pastor,1,1,1,3,Inativo
261,1,5,2459.1,Cauã Nascimento,4,3,2,9,Regular
262,45,4,5893.92,Luara Peixoto,2,2,3,7,Regular
263,33,5,3913.0,Emanuella Rocha,3,3,2,8,Regular
265,55,5,3407.43,Dra. Emanuella Novais,2,3,2,7,Regular
266,3,5,7280.83,Luiz Henrique Albuquerque,4,3,3,10,VIP
267,23,3,2268.09,Rebeca Cavalcante,3,1,2,6,Ocasional
268,109,5,8106.33,Raul Nunes,1,3,4,8,Regular
269,58,2,5359.280000000001,Sr. Pedro Lucas Nogueira,2,1,3,6,Ocasional
270,32,6,9096.939999999999,Sr. Pedro Lucas Campos,3,3,4,10,VIP
271,76,5,2537.53,Gustavo Araújo,2,3,2,7,Regular
272,54,4,5998.92,Juliana Moraes,2,2,3,7,Regular
273,40,7,10891.44,Diogo Silva,3,4,4,11,VIP
274,135,2,264.82,Ayla Guerra,1,1,1,3,Inativo
275,61,2,3933.39,Maria Alice Azevedo,2,1,2,5,Ocasional
276,84,3,5502.72,Caroline Nunes,2,1,3,6,Ocasional
277,145,3,6100.88,Allana Campos,1,1,3,5,Ocasional
278,19,4,9867.939999999999,Caleb Rezende,4,2,4,10,VIP
279,27,6,10752.380000000001,Dra. Isabel Lima,3,3,4,10,VIP
280,52,1,308.41,Valentim Rodrigues,2,1,1,4,Ocasional
281,16,6,8713.69,Ian Gomes,4,3,4,11,VIP
282,28,6,8022.33,Diego Azevedo,3,3,4,10,VIP
283,80,1,892.09,Melina Cunha,2,1,1,4,Ocasional
284,33,2,313.78999999999996,João Guilherme Ramos,3,1,1,5,Ocasional
285,41,5,2268.65,Sophia Correia,3,3,2,8,Regular
286,253,2,390.74,Ana Sophia Moura,1,1,1,3,Inativo
287,13,5,8538.220000000001,Ravy Vargas,4,3,4,11,VIP
288,64,3,8431.8,Sofia da Paz,2,1,4,7,Regular
289,183,1,2477.68,João Lucas Barros,1,1,2,4,Ocasional
290,2,5,3558.71,Ana Luiza das Neves,4,3,2,9,Regular
291,57,3,3809.42,Ana Laura das Neves,2,1,2,5,Ocasional
292,31,3,4357.200000000001,Dr. Enzo Freitas,3,1,2,6,Ocasional
293,22,4,1408.45,Ana Luiza da Luz,3,2,1,6,Ocasional
294,14,4,8397.38,José Miguel Vargas,4,2,4,10,VIP
295,311,2,2981.83,Maria Clara Gomes,1,1,2,4,Ocasional
296,67,5,2488.56,Sra. Júlia Barbosa,2,3,2,7,Regular
297,60,4,1842.9,Ravi Lucca da Paz,2,2,1,5,Ocasional
298,115,3,1768.0199999999998,Joaquim Martins,1,1,1,3,Inativo
299,53,5,5139.57,Manuella Porto,2,3,3,8,Regular
300,21,5,5022.98,Otto Mendonça,3,3,3,9,Regular
301,84,2,2909.65,Dr. Bryan Pacheco,2,1,2,5,Ocasional
302,5,3,902.8100000000001,Caroline da Costa,4,1,1,6,Ocasional
303,167,2,8718.460000000001,Davi Luiz Vasconcelos,1,1,4,6,Ocasional
304,57,1,97.39,Sr. Rael das Neves,2,1,1,4,Ocasional
305,24,6,5842.780000000001,Dra. Ana Cecília Cunha,3,3,3,9,Regular
306,94,3,1635.77,Arthur Guerra,1,1,1,3,Inativo
307,16,4,6481.5599999999995,Davi Albuquerque,4,2,3,9,Regular
308,14,4,8523.1,Antonella Pacheco,4,2,4,10,VIP
309,16,2,868.54,Asafe Martins,4,1,1,6,Ocasional
310,37,5,8960.55,Luiz Gustavo Cunha,3,3,4,10,VIP
311,259,1,47.38,Juan Monteiro,1,1,1,3,Inativo
312,18,7,6321.29,Vinicius da Cruz,4,4,3,11,VIP
313,145,3,4804.860000000001,Fernando Alves,1,1,3,5,Ocasional
314,183,3,12633.800000000001,Emanuel Brito,1,1,4,6,Ocasional
315,196,3,5075.2300000000005,Maria Cavalcanti,1,1,3,5,Ocasional
316,7,4,2289.04,Cecília Nunes,4,2,2,8,Regular
317,10,4,8784.35,Henry Almeida,4,2,4,10,VIP
318,92,2,660.53,Sr. Antônio Casa Grande,1,1,1,3,Inativo
319,69,3,1925.79,Beatriz Fernandes,2,1,1,4,Ocasional
320,44,4,8967.76,Dra. Maria Alice Câmara,2,2,4,8,Regular
321,88,2,627.98,Dra. Maria Júlia Vargas,1,1,1,3,Inativo
322,65,6,2399.4,Cecília Farias,2,3,2,7,Regular
323,37,2,185.95,Lívia Machado,3,1,1,5,Ocasional
324,23,7,5653.22,Srta. Ana Julia Gomes,3,4,3,10,VIP
325,55,4,7900.28,Rhavi Viana,2,2,4,8,Regular
326,3,8,10624.39,Brayan Fernandes,4,4,4,12,VIP
327,14,6,10345.94,Rafaela Santos,4,3,4,11,VIP
328,2,6,5016.38,Nicolas Sampaio,4,3,3,10,VIP
329,46,3,423.71,Daniela Aragão,2,1,1,4,Ocasional
330,14,5,11203.62,Lavínia Barros,4,3,4,11,VIP
331,38,3,1728.42,Maria Julia Cirino,3,1,1,5,Ocasional
332,1,6,2828.41,João Felipe Nunes,4,3,2,9,Regular
333,165,2,5749.67,Ana Liz Gomes,1,1,3,5,Ocasional
334,115,4,815.64,Srta. Sarah Oliveira,1,2,1,4,Ocasional
335,67,1,321.24,Asafe Lima,2,1,1,4,Ocasional
336,28,4,2698.37,Srta. Aurora Gomes,3,2,2,7,Regular
337,226,3,2472.52,Mariah Camargo,1,1,2,4,Ocasional
338,180,2,207.32,Vitor Gabriel Ferreira,1,1,1,3,Inativo
339,75,5,4720.61,Nathan Casa Grande,2,3,3,8,Regular
340,5,4,2191.68,Marcelo Almeida,4,2,1,7,Regular
341,24,4,3505.16,Sra. Luna da Mata,3,2,2,7,Regular
342,45,10,14216.93,Raquel Teixeira,2,4,4,10,VIP
343,81,3,4986.3099999999995,Ana Cavalcanti,2,1,3,6,Ocasional
344,35,3,2174.28,Srta. Kamilly Freitas,3,1,1,5,Ocasional
345,30,4,6033.79,Melissa Cavalcanti,3,2,3,8,Regular
346,214,3,8037.540000000001,João Miguel Alves,1,1,4,6,Ocasional
347,29,2,705.81,João Felipe Rezende,3,1,1,5,Ocasional
348,25,4,3273.92,Alexia Câmara,3,2,2,7,Regular
349,34,6,4599.8,Stephany Pinto,3,3,3,9,Regular
350,13,2,3169.08,Ana Luiza Fernandes,4,1,2,7,Regular
351,73,5,9324.61,Nathan Ribeiro,2,3,4,9,Regular
352,3,8,14559.67,Esther Fernandes,4,4,4,12,VIP
353,3,8,5194.53,Emilly da Rocha,4,4,3,11,VIP
354,2,6,9216.29,Lívia Rezende,4,3,4,11,VIP
355,28,5,8167.8,Ravi Campos,3,3,4,10,VIP
356,18,6,5343.25,Maria Helena Moura,4,3,3,10,VIP
357,9,7,7593.3,Cecília Dias,4,4,4,12,VIP
358,65,2,2453.72,Kamilly Costela,2,1,2,5,Ocasional
359,9,4,3710.4199999999996,Mariane Mendes,4,2,2,8,Regular
360,104,6,7448.07,Sr. Antony Rocha,1,3,4,8,Regular
361,94,3,4857.9,Lorena Cavalcante,1,1,3,5,Ocasional
362,192,3,7882.6900000000005,Catarina Fernandes,1,1,4,6,Ocasional
363,20,5,4736.28,Srta. Hadassa Siqueira,3,3,3,9,Regular
364,35,3,6401.29,Marcos Vinicius Porto,3,1,3,7,Regular
365,88,5,8945.42,Benicio Sales,1,3,4,8,Regular
366,47,2,5843.72,Gustavo Sales,2,1,3,6,Ocasional
367,154,7,5878.33,Cecilia Leão,1,4,3,8,Regular
368,65,1,4437.79,Gabriela Vasconcelos,2,1,3,6,Ocasional
369,63,5,1946.06,Rodrigo Farias,2,3,1,6,Ocasional
370,45,3,3050.79,Clarice Borges,2,1,2,5,Ocasional
371,303,1,288.78,Carlos Eduardo Cavalcanti,1,1,1,3,Inativo
372,11,3,4774.5599999999995,Anthony Carvalho,4,1,3,8,Regular
373,21,3,3022.21,Danilo Guerra,3,1,2,6,Ocasional
374,40,2,735.86,Bento Castro,3,1,1,5,Ocasional
375,48,2,3172.87,Ana Rodrigues,2,1,2,5,Ocasional
376,142,5,5284.96,Sr. Vinicius Vargas,1,3,3,7,Regular
377,9,2,2660.64,Manuella Ribeiro,4,1,2,7,Regular
378,167,4,4310.78,Olivia Monteiro,1,2,2,5,Ocasional
379,25,4,9007.650000000001,Yan Ramos,3,2,4,9,Regular
380,89,7,9147.039999999999,Melissa Dias,1,4,4,9,Regular
381,21,8,14677.22,Kevin Moraes,3,4,4,11,VIP
382,1,6,5015.38,Olívia Silva,4,3,3,10,VIP
383,30,3,1405.43,Lavínia Novaes,3,1,1,5,Ocasional
384,38,6,7087.45,José Miguel Pimenta,3,3,3,9,Regular
385,5,6,2876.96,Sra. Bianca Sá,4,3,2,9,Regular
386,275,1,2466.97,Sofia Carvalho,1,1,2,4,Ocasional
387,44,5,1723.2,Sophia Vasconcelos,2,3,1,6,Ocasional
388,44,3,5071.43,Dr. Otto Pereira,2,1,3,6,Ocasional
389,25,3,1342.82,Dra. Sophie da Rosa,3,1,1,5,Ocasional
390,11,2,4247.6,Dra. Emanuelly Montenegro,4,1,2,7,Regular
391,45,2,2300.44,Alice Moreira,2,1,2,5,Ocasional
392,11,6,4936.53,João Pedro Rodrigues,4,3,3,10,VIP
394,24,10,8354.0,Luara Novaes,3,4,4,11,VIP
395,135,5,16214.41,Sr. Gael da Rocha,1,3,4,8,Regular
396,49,3,2487.77,Ana Cecília Lima,2,1,2,5,Ocasional
397,104,7,8800.98,Asafe Cassiano,1,4,4,9,Regular
398,50,9,16631.76,Vicente Azevedo,2,4,4,10,VIP
399,38,2,3076.75,Luísa Farias,3,1,2,6,Ocasional
400,84,3,7185.0,Manuella Machado,2,1,3,6,Ocasional
401,81,3,6210.03,Sra. Amanda Moreira,2,1,3,6,Ocasional
402,21,6,6277.99,Antonella Brito,3,3,3,9,Regular
403,72,3,4370.95,Otávio Caldeira,2,1,2,5,Ocasional
404,37,4,4418.4,Raul Silva,3,2,3,8,Regular
405,30,6,5018.32,Heloísa da Luz,3,3,3,9,Regular
406,30,3,393.93,Vitor Abreu,3,1,1,5,Ocasional
407,134,3,1468.81,Liz Pereira,1,1,1,3,Inativo
408,147,3,4745.17,Davi Luiz Souza,1,1,3,5,Ocasional
409,181,3,4506.28,Dra. Maria Fernanda Albuquerque,1,1,3,5,Ocasional
410,8,4,3292.31,Dra. Manuella Cunha,4,2,2,8,Regular
411,105,5,3273.8599999999997,Gael Camargo,1,3,2,6,Ocasional
413,104,3,5037.41,Bernardo Correia,1,1,3,5,Ocasional
414,115,3,698.74,Dr. Paulo Cavalcante,1,1,1,3,Inativo
415,116,3,7457.86,Dr. Ravi Machado,1,1,4,6,Ocasional
416,142,5,12559.48,Davi Miguel Nascimento,1,3,4,8,Regular
417,239,1,250.1,Ana Pacheco,1,1,1,3,Inativo
418,165,3,2739.29,Olivia Rezende,1,1,2,4,Ocasional
419,4,4,2878.8199999999997,Maria Clara Montenegro,4,2,2,8,Regular
420,84,4,4942.08,Felipe Nunes,2,2,3,7,Regular
421,22,2,2427.15,Léo da Conceição,3,1,2,6,Ocasional
422,31,7,7816.17,Lorenzo Caldeira,3,4,4,11,VIP
423,92,5,13672.289999999999,Ana Vitória Moreira,1,3,4,8,Regular
424,15,7,4357.25,Alana Montenegro,4,4,2,10,VIP
425,25,5,2888.0299999999997,Francisco Castro,3,3,2,8,Regular
426,46,7,10525.31,Enrico Ramos,2,4,4,10,VIP
427,168,3,1663.54,Sophie Aparecida,1,1,1,3,Inativo
428,12,1,385.26,Allana Silveira,4,1,1,6,Ocasional
429,94,4,7320.38,Cecília Vieira,1,2,4,7,Regular
430,46,2,1123.3799999999999,Caroline Caldeira,2,1,1,4,Ocasional
431,148,3,1246.78,Ana Carolina Viana,1,1,1,3,Inativo
432,59,4,7042.68,Marina Moreira,2,2,3,7,Regular
433,13,6,5861.860000000001,Sr. Otávio Carvalho,4,3,3,10,VIP
434,89,2,238.71,Vicente Campos,1,1,1,3,Inativo
435,41,2,1014.6800000000001,Isis da Luz,3,1,1,5,Ocasional
436,24,5,1651.15,Rafaela Cavalcanti,3,3,1,7,Regular
437,142,4,3284.07,Bárbara Souza,1,2,2,5,Ocasional
438,73,3,2045.5,Sr. Enrico Gomes,2,1,1,4,Ocasional
439,49,5,4301.13,Arthur Miguel Silveira,2,3,2,7,Regular
440,9,9,8091.5599999999995,Sabrina Macedo,4,4,4,12,VIP
441,13,4,4613.9400000000005,Isabel Pimenta,4,2,3,9,Regular
442,54,1,385.4,Maria Rios,2,1,1,4,Ocasional
443,49,2,3505.98,Yan da Paz,2,1,2,5,Ocasional
444,3,6,12507.98,Erick Jesus,4,3,4,11,VIP
445,42,2,3855.7799999999997,Vitor Gabriel Vieira,3,1,2,6,Ocasional
446,26,5,9720.359999999999,Natália Pastor,3,3,4,10,VIP
447,28,4,1491.83,Ian Dias,3,2,1,6,Ocasional
448,34,6,12070.75,Caleb Guerra,3,3,4,10,VIP
449,39,5,2867.3900000000003,Dra. Esther Monteiro,3,3,2,8,Regular
450,171,2,1854.33,Maria Alice Cassiano,1,1,1,3,Inativo
451,72,2,4341.4800000000005,Rodrigo Freitas,2,1,2,5,Ocasional
452,40,7,15164.470000000001,Davi Lucas Aragão,3,4,4,11,VIP
453,46,6,3047.21,Dra. Natália Dias,2,3,2,7,Regular
454,231,2,6684.09,Francisco Novaes,1,1,3,5,Ocasional
455,38,5,3450.9300000000003,Maria Fernanda Fonseca,3,3,2,8,Regular
456,139,3,4100.74,João Gabriel da Costa,1,1,2,4,Ocasional
458,240,4,2810.18,Henrique da Cunha,1,2,2,5,Ocasional
459,351,1,3355.93,Luiz Felipe Almeida,1,1,2,4,Ocasional
461,22,4,4746.57,Clara Cavalcante,3,2,3,8,Regular
462,13,6,5097.2300000000005,Dr. João Vitor Santos,4,3,3,10,VIP
463,23,3,1150.91,Isaac Ribeiro,3,1,1,5,Ocasional
464,36,7,3654.88,Ana Júlia Alves,3,4,2,9,Regular
465,78,3,3659.81,Maria Julia das Neves,2,1,2,5,Ocasional
466,49,3,1033.6599999999999,Arthur Andrade,2,1,1,4,Ocasional
467,78,7,5642.34,Dra. Emanuelly Pastor,2,4,3,9,Regular
468,47,1,581.93,Ágatha da Conceição,2,1,1,4,Ocasional
469,133,5,10198.44,Catarina Ferreira,1,3,4,8,Regular
470,55,6,6561.16,Lavínia Peixoto,2,3,3,8,Regular
471,16,5,4147.83,Enrico Silva,4,3,2,9,Regular
472,18,10,7038.11,Júlia da Paz,4,4,3,11,VIP
473,50,7,2455.1800000000003,Milena da Mata,2,4,2,8,Regular
474,57,4,15951.33,João Miguel da Mata,2,2,4,8,Regular
475,3,8,16921.5,Luigi Leão,4,4,4,12,VIP
476,138,2,8137.35,Benjamin da Mata,1,1,4,6,Ocasional
477,133,5,4391.38,Alice Campos,1,3,3,7,Regular
478,2,6,12228.720000000001,Srta. Stephany Rios,4,3,4,11,VIP
479,72,5,4004.02,Dra. Stephany Campos,2,3,2,7,Regular
480,32,6,8412.84,Pedro Henrique Duarte,3,3,4,10,VIP
481,60,7,4909.34,Renan Sales,2,4,3,9,Regular
482,130,3,763.0899999999999,Maitê Teixeira,1,1,1,3,Inativo
483,88,3,2417.6800000000003,Ryan da Conceição,1,1,2,4,Ocasional
484,49,3,1253.82,Maysa Novais,2,1,1,4,Ocasional
485,19,4,3096.06,Kamilly Peixoto,4,2,2,8,Regular
486,38,2,1711.93,Thiago Garcia,3,1,1,5,Ocasional
487,286,1,4102.35,Maria Julia Correia,1,1,2,4,Ocasional
488,30,4,4324.24,Vicente Ribeiro,3,2,2,7,Regular
489,144,3,4411.05,Arthur Gabriel Oliveira,1,1,3,5,Ocasional
490,159,3,2541.63,Anthony Gabriel Costela,1,1,2,4,Ocasional
491,17,2,6252.24,Maria Eduarda Vieira,4,1,3,8,Regular
492,128,2,961.99,Henrique Moreira,1,1,1,3,Inativo
493,2,3,845.66,Emanuelly Novais,4,1,1,6,Ocasional
494,75,4,2256.29,Enzo Vieira,2,2,1,5,Ocasional
495,66,5,9584.25,Maria Dias,2,3,4,9,Regular
496,107,2,713.1600000000001,Jade Fonseca,1,1,1,3,Inativo
497,3,7,11668.720000000001,Kevin Abreu,4,4,4,12,VIP
498,11,4,1503.78,Daniela Brito,4,2,1,7,Regular
499,102,4,3098.38,Igor da Cunha,1,2,2,5,Ocasional
500,35,2,2523.88,Emanuella Mendonça,3,1,2,6,Ocasional
501,87,7,7823.09,Maria Vitória Campos,2,4,4,10,VIP
502,5,2,5161.09,Clarice Duarte,4,1,3,8,Regular
503,28,3,5579.33,Lavínia Viana,3,1,3,7,Regular
504,28,2,739.29,Maria Liz da Luz,3,1,1,5,Ocasional
505,19,5,7672.33,Ryan Gonçalves,4,3,4,11,VIP
506,45,2,1056.8899999999999,Aurora Camargo,2,1,1,4,Ocasional
507,14,4,3260.76,Leandro Cavalcante,4,2,2,8,Regular
508,99,6,3869.98,Bryan Camargo,1,3,2,6,Ocasional
509,9,5,6498.3,Rael Melo,4,3,3,10,VIP
510,12,4,2251.06,Yan Mendes,4,2,1,7,Regular
511,3,7,15868.22,João Gabriel Aragão,4,4,4,12,VIP
512,195,2,2167.75,Maria Cecília Caldeira,1,1,1,3,Inativo
513,1,4,12376.11,Yasmin Borges,4,2,4,10,VIP
514,2,4,4268.84,Lucas Gabriel Mendonça,4,2,2,8,Regular
515,58,7,6255.75,Theodoro da Mota,2,4,3,9,Regular
516,12,5,8085.659999999999,Dr. Davi Miguel Borges,4,3,4,11,VIP
517,52,4,6653.15,Luana Pereira,2,2,3,7,Regular
518,32,4,7318.51,Davi Miguel das Neves,3,2,3,8,Regular
519,81,6,3189.62,Srta. Ester Dias,2,3,2,7,Regular
520,7,5,7369.78,Kamilly Cassiano,4,3,4,11,VIP
521,179,1,2406.72,Isabel Peixoto,1,1,2,4,Ocasional
522,96,4,2966.24,Olivia Silva,1,2,2,5,Ocasional
523,25,6,2796.15,Alice da Mata,3,3,2,8,Regular
524,129,3,3013.37,Rebeca Sales,1,1,2,4,Ocasional
525,17,12,14376.39,Sra. Maria Júlia Pimenta,4,4,4,12,VIP
526,5,7,12895.58,Srta. Maria Julia Moreira,4,4,4,12,VIP
527,260,4,1967.1599999999999,Benjamim Sales,1,2,1,4,Ocasional
528,220,2,2602.9300000000003,Ísis Carvalho,1,1,2,4,Ocasional
529,19,5,7132.97,Srta. Mirella Borges,4,3,3,10,VIP
530,8,7,8627.39,Vinicius Santos,4,4,4,12,VIP
531,29,5,4236.04,Lucas Gabriel Nunes,3,3,2,8,Regular
532,56,5,1882.31,Laura Pires,2,3,1,6,Ocasional
533,74,5,6760.36,Sara Monteiro,2,3,3,8,Regular
534,67,4,6862.13,Melina Barros,2,2,3,7,Regular
535,63,1,214.47,Marcela Andrade,2,1,1,4,Ocasional
536,7,4,9920.64,Enrico Rocha,4,2,4,10,VIP
537,10,3,9674.47,Dr. Bernardo Teixeira,4,1,4,9,Regular
538,60,2,1323.48,Dr. Vinicius Costela,2,1,1,4,Ocasional
539,83,4,5613.53,Sra. Mariane Pereira,2,2,3,7,Regular
540,1,5,10477.369999999999,Sara Monteiro,4,3,4,11,VIP
541,20,9,16232.800000000001,Bárbara Sousa,3,4,4,11,VIP
542,36,3,3657.41,Guilherme Sales,3,1,2,6,Ocasional
543,34,6,10505.33,Dr. Arthur Cavalcanti,3,3,4,10,VIP
544,26,8,8614.060000000001,Raul Nascimento,3,4,4,11,VIP
545,43,5,5067.33,Lucas Vieira,3,3,3,9,Regular
546,6,6,6460.72,Maria Julia Cirino,4,3,3,10,VIP
547,25,6,2402.56,Isabela Freitas,3,3,2,8,Regular
548,10,3,1065.35,Caleb Macedo,4,1,1,6,Ocasional
549,19,6,6625.14,Luana Vasconcelos,4,3,3,10,VIP
550,45,4,6220.39,Stephany Camargo,2,2,3,7,Regular
551,15,8,9097.779999999999,Vicente Vargas,4,4,4,12,VIP
552,53,3,1877.8700000000001,Vitor Dias,2,1,1,4,Ocasional
553,18,2,3362.5199999999995,Sophie Caldeira,4,1,2,7,Regular
554,280,1,95.62,Isabelly Cavalcante,1,1,1,3,Inativo
555,9,7,5023.92,Ana Julia Caldeira,4,4,3,11,VIP
556,17,7,19755.170000000002,Sra. Maria Alice das Neves,4,4,4,12,VIP
557,96,4,1603.15,Sra. Aylla Marques,1,2,1,4,Ocasional
558,157,2,769.88,Emilly Sampaio,1,1,1,3,Inativo
559,57,3,2644.5,Eloá da Paz,2,1,2,5,Ocasional
560,187,1,121.74,Vitor Martins,1,1,1,3,Inativo
561,64,5,2390.51,Ana Luiza Fernandes,2,3,2,7,Regular
562,48,3,388.23,Ryan Camargo,2,1,1,4,Ocasional
563,16,5,5219.76,Mateus Duarte,4,3,3,10,VIP
565,17,4,1868.8700000000001,Luiza da Rosa,4,2,1,7,Regular
566,87,5,4970.35,Juan Araújo,2,3,3,8,Regular
567,71,4,16413.879999999997,Dra. Maria Júlia Pires,2,2,4,8,Regular
568,78,4,4529.42,Matheus Fonseca,2,2,3,7,Regular
569,76,4,5936.65,Diego Silveira,2,2,3,7,Regular
570,111,4,10472.74,Mariana Pinto,1,2,4,7,Regular
571,31,3,9979.15,Alana Oliveira,3,1,4,8,Regular
572,82,2,256.21,Rodrigo Santos,2,1,1,4,Ocasional
573,59,6,14398.62,Ravi Lucca Moreira,2,3,4,9,Regular
574,33,5,7090.97,Vitor Hugo Pacheco,3,3,3,9,Regular
575,201,3,1055.6399999999999,Dr. Luiz Gustavo da Rocha,1,1,1,3,Inativo
576,5,7,7857.4800000000005,Eloá Oliveira,4,4,4,12,VIP
577,42,8,6834.67,Ana Vitória Viana,3,4,3,10,VIP
578,73,3,556.27,Dom Ribeiro,2,1,1,4,Ocasional
579,177,3,1497.0,Ana Beatriz Fernandes,1,1,1,3,Inativo
580,35,6,4695.93,Dra. Eloah Costela,3,3,3,9,Regular
581,5,4,1907.02,Yasmin da Conceição,4,2,1,7,Regular
582,31,4,4945.04,João Pedro Machado,3,2,3,8,Regular
583,152,2,3310.78,Júlia Farias,1,1,2,4,Ocasional
584,36,6,7751.22,Vicente Fernandes,3,3,4,10,VIP
585,105,4,7543.129999999999,Bella Rodrigues,1,2,4,7,Regular
586,4,4,4868.81,Benjamin Peixoto,4,2,3,9,Regular
587,154,2,2687.6000000000004,Ester Camargo,1,1,2,4,Ocasional
588,116,4,4039.62,Paulo Sales,1,2,2,5,Ocasional
589,116,6,5963.25,José Pedro da Luz,1,3,3,7,Regular
590,62,4,7635.98,Bianca Casa Grande,2,2,4,8,Regular
591,11,8,10498.64,Brayan Barbosa,4,4,4,12,VIP
592,9,6,9416.07,Lucas Gonçalves,4,3,4,11,VIP
594,14,6,2962.41,Sr. Raul Teixeira,4,3,2,9,Regular
595,43,5,10564.38,Luiz Henrique Mendonça,3,3,4,10,VIP
596,224,3,5549.370000000001,Dra. Isabella Mendonça,1,1,3,5,Ocasional
597,42,3,724.02,Arthur Miguel Fernandes,3,1,1,5,Ocasional
598,15,6,8636.71,Natália Rocha,4,3,4,11,VIP
599,82,3,5801.7,Ana Clara da Cruz,2,1,3,6,Ocasional
600,83,2,689.9,Eloá Pastor,2,1,1,4,Ocasional
601,30,4,1484.12,Dr. Luan Campos,3,2,1,6,Ocasional
602,234,2,2356.13,João Guilherme Casa Grande,1,1,2,4,Ocasional
603,258,2,2101.84,Davi Luiz Brito,1,1,1,3,Inativo
604,102,4,7187.23,João Miguel Leão,1,2,3,6,Ocasional
605,61,1,208.98,Isabella Cavalcanti,2,1,1,4,Ocasional
606,2,9,13202.99,Luiz Fernando Leão,4,4,4,12,VIP
607,11,7,2385.9900000000002,Sofia Câmara,4,4,2,10,VIP
608,57,2,1544.04,Renan Monteiro,2,1,1,4,Ocasional
609,12,3,2352.6,Isis Farias,4,1,2,7,Regular
610,191,4,2552.76,Ryan Moraes,1,2,2,5,Ocasional
611,83,5,5722.55,Dra. Lunna da Conceição,2,3,3,8,Regular
612,66,4,6497.07,Hellena Barbosa,2,2,3,7,Regular
613,175,7,10077.849999999999,Maria Fernanda Carvalho,1,4,4,9,Regular
614,57,8,12337.6,Dra. Ana Liz da Mota,2,4,4,10,VIP
615,160,3,3886.81,Eduarda Vieira,1,1,2,4,Ocasional
616,76,4,8553.85,Anthony Gabriel Siqueira,2,2,4,8,Regular
617,26,3,1556.29,Clarice Oliveira,3,1,1,5,Ocasional
618,100,2,7308.52,Maria Júlia Mendes,1,1,3,5,Ocasional
619,11,3,619.5999999999999,Sra. Helena Cardoso,4,1,1,6,Ocasional
620,10,3,3223.15,Amanda Marques,4,1,2,7,Regular
621,89,2,3134.36,Agatha Pires,1,1,2,4,Ocasional
622,36,3,1351.12,Dra. Ágatha Oliveira,3,1,1,5,Ocasional
623,283,2,3954.96,Daniel Gomes,1,1,2,4,Ocasional
624,38,4,7595.4,Srta. Cecilia Farias,3,2,4,9,Regular
625,10,3,7118.01,Srta. Heloisa Duarte,4,1,3,8,Regular
626,73,3,1952.15,Sarah Moura,2,1,1,4,Ocasional
627,97,6,6684.97,Srta. Esther Marques,1,3,3,7,Regular
628,97,4,5549.5,Srta. Sara Cassiano,1,2,3,6,Ocasional
629,32,3,2675.48,Melina Sousa,3,1,2,6,Ocasional
630,98,4,2594.65,Lívia Jesus,1,2,2,5,Ocasional
631,15,7,13557.23,Enzo Gabriel Vieira,4,4,4,12,VIP
632,12,6,5941.39,Enrico Silva,4,3,3,10,VIP
633,53,7,6028.76,Carolina Macedo,2,4,3,9,Regular
634,110,3,2251.41,Marcelo Machado,1,1,1,3,Inativo
635,44,7,12162.25,Luiza Cassiano,2,4,4,10,VIP
636,19,4,4112.400000000001,Clara Nunes,4,2,2,8,Regular
637,338,1,2678.93,Apollo Guerra,1,1,2,4,Ocasional
638,48,3,3349.54,Gael Henrique Almeida,2,1,2,5,Ocasional
639,10,6,10141.27,Sr. Luiz Miguel Gonçalves,4,3,4,11,VIP
640,85,4,1988.39,Aurora Cunha,2,2,1,5,Ocasional
641,83,5,7870.6900000000005,Caio Casa Grande,2,3,4,9,Regular
642,35,1,1467.67,Nicolas Porto,3,1,1,5,Ocasional
643,59,3,7333.67,Yuri Mendonça,2,1,4,7,Regular
644,45,2,401.97,Kaique Porto,2,1,1,4,Ocasional
645,59,8,11973.400000000001,Isabelly Alves,2,4,4,10,VIP
646,62,7,11376.96,Maya da Luz,2,4,4,10,VIP
647,16,6,15489.68,Liam Martins,4,3,4,11,VIP
648,24,2,2406.54,Sr. João Vitor da Rocha,3,1,2,6,Ocasional
649,8,6,6952.469999999999,Yago Duarte,4,3,3,10,VIP
650,141,1,910.35,Dr. Noah Fernandes,1,1,1,3,Inativo
651,22,5,3956.37,Valentina Nascimento,3,3,2,8,Regular
652,8,7,4797.4800000000005,Luiz Miguel Carvalho,4,4,3,11,VIP
653,13,4,6147.0,Henry Cardoso,4,2,3,9,Regular
654,29,3,2601.19,Breno Almeida,3,1,2,6,Ocasional
655,64,7,9440.380000000001,Ana Liz Melo,2,4,4,10,VIP
656,99,4,3671.55,Gustavo Pastor,1,2,2,5,Ocasional
657,130,1,2241.92,Luiz Fernando Fogaça,1,1,1,3,Inativo
658,17,4,1386.07,Alice Moura,4,2,1,7,Regular
659,53,5,4608.61,Olívia Fonseca,2,3,3,8,Regular
660,212,3,1626.24,Heloísa Jesus,1,1,1,3,Inativo
661,22,4,1850.65,Dr. Asafe Barros,3,2,1,6,Ocasional
662,7,4,6441.41,Heloisa Novaes,4,2,3,9,Regular
663,9,5,10022.8,Samuel Rocha,4,3,4,11,VIP
664,169,2,1714.55,Dra. Bella Sousa,1,1,1,3,Inativo
665,85,4,10064.16,Sara da Mota,2,2,4,8,Regular
666,75,3,3042.4900000000002,Bianca Campos,2,1,2,5,Ocasional
667,26,4,1155.9,Theo Rocha,3,2,1,6,Ocasional
668,152,5,14174.8,Vicente Vargas,1,3,4,8,Regular
669,5,6,5886.639999999999,Manuela Nogueira,4,3,3,10,VIP
670,17,2,1687.4099999999999,Melina Marques,4,1,1,6,Ocasional
671,176,4,1003.29,Mathias Mendonça,1,2,1,4,Ocasional
672,18,3,4505.87,Julia Monteiro,4,1,3,8,Regular
673,16,9,11173.0,Luiz Otávio Ferreira,4,4,4,12,VIP
674,169,2,3537.4700000000003,Marcela Araújo,1,1,2,4,Ocasional
675,112,3,7893.370000000001,Danilo Fernandes,1,1,4,6,Ocasional
676,122,5,5038.200000000001,Sophie Leão,1,3,3,7,Regular
677,21,1,255.44,Samuel Brito,3,1,1,5,Ocasional
678,46,4,5895.69,Theo Porto,2,2,3,7,Regular
679,240,3,6754.96,Caleb Silva,1,1,3,5,Ocasional
680,54,2,1022.13,Giovanna Ferreira,2,1,1,4,Ocasional
681,9,2,1515.12,Isis Pinto,4,1,1,6,Ocasional
682,75,2,283.87,Theo Cunha,2,1,1,4,Ocasional
683,49,4,1983.8899999999999,Clara da Costa,2,2,1,5,Ocasional
684,145,7,8222.51,Enrico da Cunha,1,4,4,9,Regular
685,134,5,10763.63,Ravi Mendonça,1,3,4,8,Regular
686,162,2,861.63,João Lucas Ribeiro,1,1,1,3,Inativo
687,27,3,4030.5099999999998,Benício Jesus,3,1,2,6,Ocasional
688,46,4,6620.68,Vicente Rios,2,2,3,7,Regular
689,46,7,4842.82,Maria Julia Souza,2,4,3,9,Regular
690,10,4,3695.61,Maria Luísa da Cunha,4,2,2,8,Regular
691,128,3,3549.9,Isadora da Mota,1,1,2,4,Ocasional
692,65,3,1485.6,Ana Beatriz Sousa,2,1,1,4,Ocasional
693,55,6,6084.92,Isabela Macedo,2,3,3,8,Regular
694,12,5,3547.41,Pedro Lucas Pires,4,3,2,9,Regular
695,17,5,6480.400000000001,Dr. Carlos Eduardo Castro,4,3,3,10,VIP
696,9,1,1457.78,Ester Pires,4,1,1,6,Ocasional
697,45,3,1884.79,Sr. Daniel Castro,2,1,1,4,Ocasional
698,43,4,9186.27,Dr. Rhavi Sousa,3,2,4,9,Regular
699,114,2,2189.58,Matteo Garcia,1,1,1,3,Inativo
700,267,3,2754.7999999999997,Srta. Ana Julia Guerra,1,1,2,4,Ocasional
701,117,3,1726.76,Anthony Gabriel Silva,1,1,1,3,Inativo
702,296,1,1746.19,João Pedro Souza,1,1,1,3,Inativo
703,53,5,6232.41,Gabriel Leão,2,3,3,8,Regular
704,120,3,4925.98,Isadora Freitas,1,1,3,5,Ocasional
705,29,4,7112.9400000000005,Matheus Santos,3,2,3,8,Regular
706,157,4,7849.72,Sr. Ravy Fogaça,1,2,4,7,Regular
707,26,2,927.97,Ana Cecília Pacheco,3,1,1,5,Ocasional
708,64,3,7395.15,Dra. Marina Casa Grande,2,1,4,7,Regular
709,47,6,8534.09,João Pimenta,2,3,4,9,Regular
710,36,4,4960.21,Maysa Aragão,3,2,3,8,Regular
711,58,7,4949.91,Sra. Maya Camargo,2,4,3,9,Regular
712,201,2,3192.04,Davi Ferreira,1,1,2,4,Ocasional
713,17,5,1832.93,Hadassa Pacheco,4,3,1,8,Regular
714,58,4,5306.38,Lucas Alves,2,2,3,7,Regular
715,40,9,13975.19,Pietra Marques,3,4,4,11,VIP
716,17,4,4260.9,Caroline Cunha,4,2,2,8,Regular
717,44,5,6056.52,Maria Helena Borges,2,3,3,8,Regular
718,9,2,2357.45,Larissa Ramos,4,1,2,7,Regular
719,27,4,3966.94,Sr. Léo Moraes,3,2,2,7,Regular
720,40,5,7200.2,Maria Eduarda Pimenta,3,3,3,9,Regular
721,110,4,1760.74,Heloisa Ramos,1,2,1,4,Ocasional
722,52,1,3300.75,Letícia Cassiano,2,1,2,5,Ocasional
723,48,3,3120.06,Théo Caldeira,2,1,2,5,Ocasional
724,5,6,7227.63,Allana Camargo,4,3,3,10,VIP
725,51,2,545.44,Levi Pastor,2,1,1,4,Ocasional
726,27,3,1620.6399999999999,Dra. Joana Rocha,3,1,1,5,Ocasional
727,37,6,9826.26,Pietra Marques,3,3,4,10,VIP
728,43,7,6253.15,Dr. Kevin Borges,3,4,3,10,VIP
729,127,6,3754.82,Gustavo Henrique Mendes,1,3,2,6,Ocasional
730,104,4,3162.7200000000003,Renan Lima,1,2,2,5,Ocasional
731,54,2,1239.02,Isabelly Costa,2,1,1,4,Ocasional
732,13,2,1293.22,Sabrina Sousa,4,1,1,6,Ocasional
733,42,7,7894.5,Luara Novaes,3,4,4,11,VIP
734,56,7,13108.23,Dr. Pedro Henrique Almeida,2,4,4,10,VIP
735,11,7,12745.39,Maitê Pereira,4,4,4,12,VIP
736,43,2,1362.1,Gustavo Henrique da Paz,3,1,1,5,Ocasional
737,71,3,1704.1,Oliver Monteiro,2,1,1,4,Ocasional
738,29,5,11443.46,Erick Montenegro,3,3,4,10,VIP
739,39,7,8510.48,Ryan da Luz,3,4,4,11,VIP
740,19,5,11948.68,Benicio Macedo,4,3,4,11,VIP
741,8,5,7535.639999999999,Dante Costela,4,3,4,11,VIP
742,12,3,4700.49,Sr. Davi Costa,4,1,3,8,Regular
743,126,3,7244.06,Bryan da Mata,1,1,3,5,Ocasional
744,184,5,7758.58,Maria Luísa Marques,1,3,4,8,Regular
745,126,3,1250.8,Pedro Henrique Araújo,1,1,1,3,Inativo
746,27,7,12015.490000000002,Dra. Stephany da Rocha,3,4,4,11,VIP
747,7,6,2245.77,Vinícius Pimenta,4,3,1,8,Regular
748,1,4,5470.02,Melina Sampaio,4,2,3,9,Regular
749,88,2,2448.54,Dra. Carolina Moreira,1,1,2,4,Ocasional
750,21,6,5080.67,Arthur Vieira,3,3,3,9,Regular
751,2,4,3201.09,Thiago Fogaça,4,2,2,8,Regular
752,43,3,4272.11,Vitor Peixoto,3,1,2,6,Ocasional
753,48,3,4182.99,Cauã Duarte,2,1,2,5,Ocasional
754,41,5,7242.92,Caleb Araújo,3,3,3,9,Regular
755,6,2,1044.0900000000001,Stella Vasconcelos,4,1,1,6,Ocasional
756,265,2,3000.7,Diego Montenegro,1,1,2,4,Ocasional
757,34,4,4131.89,Heitor Marques,3,2,2,7,Regular
758,37,5,2583.91,Lavínia Aparecida,3,3,2,8,Regular
759,5,3,1247.04,Diego Viana,4,1,1,6,Ocasional
760,4,5,10714.61,Davi Novaes,4,3,4,11,VIP
761,10,4,9329.81,Caroline Teixeira,4,2,4,10,VIP
762,41,4,2105.38,Sr. Nicolas Gomes,3,2,1,6,Ocasional
763,53,8,3214.2599999999998,Aurora Cavalcante,2,4,2,8,Regular
764,32,3,2008.4199999999998,Ágatha Oliveira,3,1,1,5,Ocasional
765,16,4,2664.32,Emilly Almeida,4,2,2,8,Regular
766,7,7,7609.04,Ana Clara Mendonça,4,4,4,12,VIP
767,4,4,1649.06,Danilo Brito,4,2,1,7,Regular
768,91,4,4286.16,Eloá Araújo,1,2,2,5,Ocasional
769,13,5,2633.2799999999997,Dr. Marcos Vinicius Campos,4,3,2,9,Regular
770,43,5,4568.4,Bruna da Mata,3,3,3,9,Regular
771,21,7,7379.72,Antony da Mata,3,4,4,11,VIP
772,83,4,7258.120000000001,Marcelo Nogueira,2,2,3,7,Regular
773,77,5,1941.28,Lavínia Rezende,2,3,1,6,Ocasional
774,36,8,13578.17,Sr. Thomas da Paz,3,4,4,11,VIP
775,1,10,12041.15,Davi Miguel Silveira,4,4,4,12,VIP
776,13,5,11982.85,Sra. Júlia da Cruz,4,3,4,11,VIP
777,14,6,8113.589999999999,Olívia Abreu,4,3,4,11,VIP
778,34,3,4938.780000000001,Ana Vitória Nascimento,3,1,3,7,Regular
779,14,6,11000.11,Maria Alice Gomes,4,3,4,11,VIP
780,78,4,4437.37,João Lucas Rodrigues,2,2,3,7,Regular
781,6,4,4694.429999999999,Sr. João Lucas Monteiro,4,2,3,9,Regular
782,81,4,3487.45,Yuri Correia,2,2,2,6,Ocasional
783,18,7,6209.51,Vicente Siqueira,4,4,3,11,VIP
784,15,6,4442.73,Ana Júlia Duarte,4,3,3,10,VIP
786,17,3,1833.91,Amanda Sousa,4,1,1,6,Ocasional
787,356,2,3160.88,Aylla Alves,1,1,2,4,Ocasional
788,118,2,3300.0,Sr. Lucas Gabriel Moreira,1,1,2,4,Ocasional
789,24,2,1749.08,Bryan Araújo,3,1,1,5,Ocasional
790,315,1,4879.94,Ana Laura da Rosa,1,1,3,5,Ocasional
791,7,3,2000.0700000000002,Maria Liz Brito,4,1,1,6,Ocasional
792,14,3,1276.83,Beatriz Fernandes,4,1,1,6,Ocasional
794,11,3,5526.59,Bento Cardoso,4,1,3,8,Regular
795,8,4,9359.07,Dr. Léo Albuquerque,4,2,4,10,VIP
796,92,8,17464.6,Guilherme Viana,1,4,4,9,Regular
797,14,2,1170.3700000000001,Dr. Kaique Leão,4,1,1,6,Ocasional
798,216,2,591.0799999999999,Ravi Lucca Pinto,1,1,1,3,Inativo
799,55,8,7346.889999999999,Luiz Miguel Albuquerque,2,4,4,10,VIP
800,51,3,855.01,Maria Cecília Aparecida,2,1,1,4,Ocasional
801,84,2,1545.8,Sr. Felipe Costa,2,1,1,4,Ocasional
802,24,3,7213.13,Lucca Costela,3,1,3,7,Regular
803,35,2,289.45,Ana Luiza Campos,3,1,1,5,Ocasional
804,78,1,123.08,Dr. Joaquim Aparecida,2,1,1,4,Ocasional
805,87,5,10108.43,Thomas Pacheco,2,3,4,9,Regular
806,78,3,3484.5699999999997,Maria Julia Sá,2,1,2,5,Ocasional
807,28,2,486.25,Sra. Olívia da Mata,3,1,1,5,Ocasional
808,7,9,7313.4400000000005,Isabela Gonçalves,4,4,3,11,VIP
809,14,5,8225.49,Bryan da Rocha,4,3,4,11,VIP
810,42,5,4063.09,Milena Martins,3,3,2,8,Regular
811,81,7,5321.139999999999,João Ramos,2,4,3,9,Regular
813,34,2,2025.32,Dra. Kamilly Correia,3,1,1,5,Ocasional
814,22,4,4025.46,Alice Melo,3,2,2,7,Regular
815,61,4,3691.8,Nina Silveira,2,2,2,6,Ocasional
816,179,3,4517.63,Giovanna Macedo,1,1,3,5,Ocasional
817,41,9,7938.29,Srta. Sara Ribeiro,3,4,4,11,VIP
818,29,3,5335.98,Arthur Gabriel Carvalho,3,1,3,7,Regular
819,87,4,2838.5499999999997,Esther Melo,2,2,2,6,Ocasional
820,161,3,2735.71,Arthur Gabriel Sales,1,1,2,4,Ocasional
821,16,5,4680.95,Vinicius Azevedo,4,3,3,10,VIP
822,25,4,1039.66,Maria Júlia Castro,3,2,1,6,Ocasional
823,15,7,7319.01,Davi Lucca Costela,4,4,3,11,VIP
824,281,1,2701.9,Kamilly Costa,1,1,2,4,Ocasional
825,37,7,5797.71,Rebeca Marques,3,4,3,10,VIP
826,15,4,2471.8199999999997,Manuella Sampaio,4,2,2,8,Regular
827,8,3,1016.9,Maria Isis Ribeiro,4,1,1,6,Ocasional
828,31,3,5457.6,Zoe da Rocha,3,1,3,7,Regular
829,87,5,11442.64,Cauã Montenegro,2,3,4,9,Regular
830,15,4,2341.2,Ravi Garcia,4,2,2,8,Regular
831,242,3,759.39,Luan Rios,1,1,1,3,Inativo
832,97,5,2814.64,Cecilia Melo,1,3,2,6,Ocasional
833,115,8,17284.9,Sra. Eloá Barbosa,1,4,4,9,Regular
834,52,3,4007.07,Yasmin Cunha,2,1,2,5,Ocasional
835,4,5,3778.77,André Aragão,4,3,2,9,Regular
836,78,2,3152.7400000000002,Anthony Gabriel Fernandes,2,1,2,5,Ocasional
837,190,4,3886.57,Bianca Duarte,1,2,2,5,Ocasional
838,2,5,5754.74,Dr. Erick Albuquerque,4,3,3,10,VIP
839,39,3,2785.68,Léo Aparecida,3,1,2,6,Ocasional
840,19,3,5939.7300000000005,Eloá da Cunha,4,1,3,8,Regular
841,38,3,2023.92,Sra. Rafaela Azevedo,3,1,1,5,Ocasional
842,131,1,678.66,Igor Almeida,1,1,1,3,Inativo
843,28,6,11756.289999999999,Marcelo Monteiro,3,3,4,10,VIP
844,43,4,13483.66,Luísa Carvalho,3,2,4,9,Regular
845,160,4,4572.3099999999995,Dr. Joaquim Costela,1,2,3,6,Ocasional
846,12,8,10919.96,Pedro Miguel Pires,4,4,4,12,VIP
847,102,2,4793.299999999999,Davi Lucas Borges,1,1,3,5,Ocasional
848,19,7,6074.91,Luana Cavalcante,4,4,3,11,VIP
849,4,11,16500.079999999998,Gabriela da Mata,4,4,4,12,VIP
850,33,5,5337.5199999999995,Marina Teixeira,3,3,3,9,Regular
852,9,5,3611.71,Sr. Ravy Costa,4,3,2,9,Regular
853,90,5,4620.07,Sra. Maria Isis Mendonça,1,3,3,7,Regular
854,146,5,9203.029999999999,Luiz Fernando Moraes,1,3,4,8,Regular
855,40,6,4021.09,Srta. Isabelly Mendes,3,3,2,8,Regular
856,105,6,6052.25,Clara da Cunha,1,3,3,7,Regular
857,8,5,1009.75,Anna Liz Moreira,4,3,1,8,Regular
858,73,6,4321.26,Maria Helena Pastor,2,3,2,7,Regular
859,135,2,2482.82,Sra. Lorena Abreu,1,1,2,4,Ocasional
860,26,4,3211.14,Laura Siqueira,3,2,2,7,Regular
861,141,5,6290.51,Theodoro Camargo,1,3,3,7,Regular
862,36,2,1524.6000000000001,José Pedro Jesus,3,1,1,5,Ocasional
863,45,5,1790.3400000000001,João Guilherme Azevedo,2,3,1,6,Ocasional
864,25,4,3534.62,André Rios,3,2,2,7,Regular
865,159,2,2865.69,Ryan Melo,1,1,2,4,Ocasional
866,51,4,4280.48,Ana Laura Fogaça,2,2,2,6,Ocasional
867,7,5,6231.45,Lara Sampaio,4,3,3,10,VIP
868,61,2,1173.45,Luna Almeida,2,1,1,4,Ocasional
869,53,2,718.8399999999999,Dr. Renan Ribeiro,2,1,1,4,Ocasional
870,54,5,3355.66,Sofia Andrade,2,3,2,7,Regular
871,157,2,3620.37,Bruna Mendes,1,1,2,4,Ocasional
872,5,7,10070.08,Enrico Duarte,4,4,4,12,VIP
873,114,3,12388.49,Vitor Porto,1,1,4,6,Ocasional
874,233,2,1151.53,Luigi Garcia,1,1,1,3,Inativo
875,264,2,4803.25,Daniel Borges,1,1,3,5,Ocasional
876,126,4,2670.3,Leonardo Araújo,1,2,2,5,Ocasional
877,8,4,3803.92,Hellena Caldeira,4,2,2,8,Regular
878,60,2,1905.31,Mirella Casa Grande,2,1,1,4,Ocasional
879,49,8,9839.019999999999,Dra. Pietra Pires,2,4,4,10,VIP
880,4,6,5632.96,Henry Gabriel Sampaio,4,3,3,10,VIP
881,91,5,6647.88,Dr. Renan Ferreira,1,3,3,7,Regular
882,44,5,8491.93,Aylla Cardoso,2,3,4,9,Regular
883,35,3,1213.04,Lavínia Casa Grande,3,1,1,5,Ocasional
884,192,3,5369.280000000001,Diogo Garcia,1,1,3,5,Ocasional
885,76,4,3406.41,Dante Moraes,2,2,2,6,Ocasional
886,167,4,5152.27,Erick Rezende,1,2,3,6,Ocasional
887,36,5,9482.2,Maria Helena da Mota,3,3,4,10,VIP
888,41,2,3596.15,Sophia Câmara,3,1,2,6,Ocasional
889,193,1,296.48,Maya da Rosa,1,1,1,3,Inativo
890,19,3,2013.73,Zoe Viana,4,1,1,6,Ocasional
891,17,5,4209.67,Bárbara Cirino,4,3,2,9,Regular
892,148,3,1392.98,Elisa Borges,1,1,1,3,Inativo
893,238,2,2139.51,Agatha da Cruz,1,1,1,3,Inativo
894,54,6,5926.59,Maria Pereira,2,3,3,8,Regular
895,2,6,7128.04,Davi Luiz Pereira,4,3,3,10,VIP
896,35,5,9737.22,Elisa Guerra,3,3,4,10,VIP
897,102,3,3454.83,Juliana Porto,1,1,2,4,Ocasional
898,40,9,7088.91,Maria Helena Alves,3,4,3,10,VIP
899,11,6,22061.84,Sr. Luiz Miguel Farias,4,3,4,11,VIP
900,5,4,5781.31,Davi Cavalcanti,4,2,3,9,Regular
901,10,3,2148.52,Enzo Gabriel Dias,4,1,1,6,Ocasional
902,193,2,3639.39,Sophie Silva,1,1,2,4,Ocasional
903,15,4,2940.32,Mariah Santos,4,2,2,8,Regular
904,53,3,9891.369999999999,Heloísa das Neves,2,1,4,7,Regular
905,42,2,11135.45,Caleb Cavalcante,3,1,4,8,Regular
906,86,3,8570.460000000001,Srta. Pietra Monteiro,2,1,4,7,Regular
907,52,3,4406.219999999999,Dra. Manuella da Cruz,2,1,3,6,Ocasional
908,24,5,2467.13,Théo Fogaça,3,3,2,8,Regular
909,65,5,6107.639999999999,Isadora Nogueira,2,3,3,8,Regular
910,62,3,3837.42,Maria Júlia Cunha,2,1,2,5,Ocasional
911,17,4,3982.71,Dr. Luiz Gustavo Caldeira,4,2,2,8,Regular
912,76,8,8026.31,Vinícius Moraes,2,4,4,10,VIP
913,325,1,1458.26,Ravy Gonçalves,1,1,1,3,Inativo
914,10,3,1045.98,Davi Miguel Fogaça,4,1,1,6,Ocasional
915,140,5,4408.4,Miguel Leão,1,3,3,7,Regular
916,53,2,4604.900000000001,Carolina Duarte,2,1,3,6,Ocasional
917,44,6,4333.55,Eduardo Ferreira,2,3,2,7,Regular
918,8,6,14598.77,Ryan Barros,4,3,4,11,VIP
919,213,2,4923.969999999999,Josué Rios,1,1,3,5,Ocasional
920,221,1,528.74,Gabriel Pastor,1,1,1,3,Inativo
921,290,1,1948.55,Allana Pimenta,1,1,1,3,Inativo
922,18,2,3140.2,Henry Fernandes,4,1,2,7,Regular
924,3,3,4256.8,Sra. Hadassa da Paz,4,1,2,7,Regular
925,1,6,7607.11,Daniel Brito,4,3,4,11,VIP
926,145,4,20868.75,Maria Fernanda da Costa,1,2,4,7,Regular
927,13,2,722.04,Asafe Pastor,4,1,1,6,Ocasional
928,185,3,1426.2199999999998,Renan Teixeira,1,1,1,3,Inativo
929,52,5,6052.98,Sra. Manuella Fonseca,2,3,3,8,Regular
930,46,6,3911.39,Alícia Cavalcante,2,3,2,7,Regular
931,23,5,3669.3900000000003,Sabrina Rodrigues,3,3,2,8,Regular
932,50,3,1122.38,Francisco Abreu,2,1,1,4,Ocasional
933,50,3,4332.43,Dra. Valentina da Luz,2,1,2,5,Ocasional
934,254,2,156.23000000000002,João Vitor Aparecida,1,1,1,3,Inativo
935,51,5,5377.29,Vitor Camargo,2,3,3,8,Regular
936,14,2,1362.6100000000001,Davi Luiz Jesus,4,1,1,6,Ocasional
937,195,2,1839.8700000000001,Vitor Gabriel Ribeiro,1,1,1,3,Inativo
938,7,8,6806.75,Luan da Mata,4,4,3,11,VIP
939,60,2,2450.44,Rhavi Borges,2,1,2,5,Ocasional
940,4,2,2763.47,Srta. Larissa Almeida,4,1,2,7,Regular
941,51,2,1350.58,Rafael Ramos,2,1,1,4,Ocasional
942,113,5,7825.39,Beatriz Garcia,1,3,4,8,Regular
943,83,5,1472.3,Diego Pires,2,3,1,6,Ocasional
944,22,6,7555.1,Melina Castro,3,3,4,10,VIP
945,93,4,1612.6100000000001,Camila Almeida,1,2,1,4,Ocasional
946,12,2,1640.6899999999998,Henry Gabriel Alves,4,1,1,6,Ocasional
947,143,2,6382.599999999999,Maria Isis Rodrigues,1,1,3,5,Ocasional
948,11,3,4235.8,Lívia Campos,4,1,2,7,Regular
949,256,1,404.65,Otávio Cassiano,1,1,1,3,Inativo
950,55,5,15680.41,Srta. Agatha Cassiano,2,3,4,9,Regular
951,44,3,6730.280000000001,Daniel Oliveira,2,1,3,6,Ocasional
952,105,1,666.58,Maria Dias,1,1,1,3,Inativo
953,20,6,6543.849999999999,Isabelly Gomes,3,3,3,9,Regular
954,59,5,3262.24,Otto Moura,2,3,2,7,Regular
955,102,3,5567.99,Catarina Camargo,1,1,3,5,Ocasional
956,14,4,2505.88,Isabelly Costela,4,2,2,8,Regular
957,264,2,763.3599999999999,Srta. Mariana Freitas,1,1,1,3,Inativo
958,101,4,6286.38,Arthur Casa Grande,1,2,3,6,Ocasional
959,210,3,4901.52,Fernando Melo,1,1,3,5,Ocasional
961,33,6,9513.16,Anthony Gonçalves,3,3,4,10,VIP
962,32,3,2552.29,Eduarda da Mata,3,1,2,6,Ocasional
963,120,4,4192.72,Ester Souza,1,2,2,5,Ocasional
964,2,6,5907.3099999999995,Marcelo Ramos,4,3,3,10,VIP
965,160,3,3157.3199999999997,Sr. Isaque da Paz,1,1,2,4,Ocasional
966,34,3,7019.38,Gabriel Novaes,3,1,3,7,Regular
967,22,4,8794.1,Ana Clara Aragão,3,2,4,9,Regular
968,2,3,5950.0,Maria Alice Cardoso,4,1,3,8,Regular
969,5,3,1358.9,Mateus Mendes,4,1,1,6,Ocasional
970,41,4,8608.789999999999,Henrique Rodrigues,3,2,4,9,Regular
971,29,3,2775.5,Marina Aparecida,3,1,2,6,Ocasional
972,13,7,8429.18,Aylla Albuquerque,4,4,4,12,VIP
973,26,5,12086.880000000001,Enrico Azevedo,3,3,4,10,VIP
974,208,5,6328.73,Jade Teixeira,1,3,3,7,Regular
975,21,7,5749.58,Caroline Macedo,3,4,3,10,VIP
976,31,7,6062.49,Asafe Pinto,3,4,3,10,VIP
977,34,4,4872.4400000000005,Murilo Barbosa,3,2,3,8,Regular
978,7,2,3533.15,Nina Caldeira,4,1,2,7,Regular
980,34,4,7851.68,Heitor Dias,3,2,4,9,Regular
981,76,4,2144.25,Antônio Teixeira,2,2,1,5,Ocasional
982,31,7,9311.710000000001,Anna Liz da Rosa,3,4,4,11,VIP
983,30,5,3060.91,Manuela Sá,3,3,2,8,Regular
984,94,3,6547.49,Sra. Maria Sales,1,1,3,5,Ocasional
985,293,1,651.83,Clara Duarte,1,1,1,3,Inativo
986,89,6,15438.94,Julia Moreira,1,3,4,8,Regular
987,138,2,349.2,Srta. Mariah Sampaio,1,1,1,3,Inativo
988,128,1,466.98,Léo Fonseca,1,1,1,3,Inativo
989,119,5,9165.289999999999,Maria Sophia Jesus,1,3,4,8,Regular
990,42,8,6026.110000000001,Yuri Peixoto,3,4,3,10,VIP
991,20,4,3328.02,Beatriz Borges,3,2,2,7,Regular
992,116,4,10651.970000000001,Beatriz Porto,1,2,4,7,Regular
993,130,1,558.54,Maria Helena Camargo,1,1,1,3,Inativo
994,69,4,2039.79,Alana Freitas,2,2,1,5,Ocasional
995,9,3,6426.44,Ana Beatriz Albuquerque,4,1,3,8,Regular
996,21,9,8090.38,Matteo Correia,3,4,4,11,VIP
997,38,8,10477.2,Sr. Pedro Henrique da Conceição,3,4,4,11,VIP
998,73,8,9608.3,Joana Novaes,2,4,4,10,VIP
999,23,5,6086.81,Daniela Alves,3,3,3,9,Regular
1000,117,7,1865.6599999999999,Sr. Isaque Rezende,1,4,1,6,Ocasional
1001,70,4,2987.88,Joana Ribeiro,2,2,2,6,Ocasional
1002,116,3,2126.83,Raul Peixoto,1,1,1,3,Inativo
1003,44,4,1914.6100000000001,Sr. Matteo Brito,2,2,1,5,Ocasional
1004,4,3,6426.04,Mariah Garcia,4,1,3,8,Regular
1005,54,3,408.34000000000003,Ana Beatriz Campos,2,1,1,4,Ocasional
1006,61,2,1016.6700000000001,Gael Pereira,2,1,1,4,Ocasional
1007,1,5,4414.74,Arthur Duarte,4,3,3,10,VIP
1008,10,6,6108.6,Luiz Fernando Santos,4,3,3,10,VIP
1009,15,7,4362.39,Sra. Maria Júlia Caldeira,4,4,2,10,VIP
1010,8,4,1217.76,Sr. Matheus Lima,4,2,1,7,Regular
1011,148,5,7168.299999999999,Isis Pastor,1,3,3,7,Regular
1012,7,8,4873.32,Dr. Francisco Fogaça,4,4,3,11,VIP
1013,62,2,2204.44,Liam Sales,2,1,1,4,Ocasional
1014,41,4,4760.26,Ana Luiza Gomes,3,2,3,8,Regular
1015,34,2,706.8000000000001,Maya Dias,3,1,1,5,Ocasional
1016,35,4,5510.55,Eloá Peixoto,3,2,3,8,Regular
1017,64,2,1096.3200000000002,Davi Lucca Guerra,2,1,1,4,Ocasional
1018,10,7,7218.71,Liz da Mota,4,4,3,11,VIP
1019,31,6,5499.65,Sabrina Ramos,3,3,3,9,Regular
1020,63,3,914.82,Lorenzo Sales,2,1,1,4,Ocasional
1021,69,5,10600.88,Alana Sales,2,3,4,9,Regular
1022,41,4,1068.63,Dra. Maria Helena da Mata,3,2,1,6,Ocasional
1023,2,3,2585.3199999999997,Maria Sophia Porto,4,1,2,7,Regular
1024,39,6,7079.09,Lorenzo Vargas,3,3,3,9,Regular
1025,272,3,1847.2400000000002,Gustavo Sales,1,1,1,3,Inativo
1026,51,4,10518.93,Esther Mendonça,2,2,4,8,Regular
1027,18,5,2550.35,Thiago Caldeira,4,3,2,9,Regular
1028,1,4,7096.139999999999,Bernardo da Mota,4,2,3,9,Regular
1029,60,8,10196.21,Srta. Isabella Almeida,2,4,4,10,VIP
1030,129,3,4228.72,Yan Barros,1,1,2,4,Ocasional
1031,25,3,3301.8300000000004,Sr. Benicio Rezende,3,1,2,6,Ocasional
1032,49,9,13124.53,Sabrina Moreira,2,4,4,10,VIP
1033,71,8,13156.47,João Felipe da Costa,2,4,4,10,VIP
1034,65,2,3011.15,Maria Júlia Brito,2,1,2,5,Ocasional
1035,16,5,6092.589999999999,João Pedro Siqueira,4,3,3,10,VIP
1036,4,5,2638.71,Sr. Enzo Cirino,4,3,2,9,Regular
1037,155,4,3200.83,Breno Cavalcante,1,2,2,5,Ocasional
1038,52,5,3664.98,Antony Nunes,2,3,2,7,Regular
1039,22,5,4289.84,Sra. Milena Mendonça,3,3,2,8,Regular
1040,47,4,1991.5500000000002,Sra. Stella Vasconcelos,2,2,1,5,Ocasional
1041,50,3,1311.81,Cecília Fogaça,2,1,1,4,Ocasional
1042,97,4,2262.75,Bianca da Mota,1,2,1,4,Ocasional
1043,25,5,10298.619999999999,Leonardo Correia,3,3,4,10,VIP
1044,112,6,7485.6900000000005,Manuella da Paz,1,3,4,8,Regular
1045,49,3,1090.76,Enrico da Rosa,2,1,1,4,Ocasional
1046,31,5,2063.43,Camila Aragão,3,3,1,7,Regular
1047,54,5,7660.22,Dr. Theodoro Rios,2,3,4,9,Regular
1048,208,3,6971.54,João Vitor Câmara,1,1,3,5,Ocasional
1049,1,8,10263.68,Leonardo Cavalcanti,4,4,4,12,VIP
1050,29,8,9615.84,Oliver Novaes,3,4,4,11,VIP
1051,93,3,918.66,Aylla Carvalho,1,1,1,3,Inativo
1052,20,5,7236.7699999999995,Nicole Alves,3,3,3,9,Regular
1053,112,4,4500.67,Sophie Freitas,1,2,3,6,Ocasional
1054,22,4,6016.320000000001,Alana Martins,3,2,3,8,Regular
1055,3,3,2206.08,Rodrigo Sales,4,1,1,6,Ocasional
1056,124,3,2264.65,Sabrina Carvalho,1,1,2,4,Ocasional
1057,84,3,1340.44,Srta. Bruna Azevedo,2,1,1,4,Ocasional
1058,161,3,781.36,Thiago Macedo,1,1,1,3,Inativo
1059,111,3,2905.24,Joana Pimenta,1,1,2,4,Ocasional
1060,124,3,5620.49,Dra. Isabella Cavalcante,1,1,3,5,Ocasional
1061,52,1,1040.71,Kamilly Gonçalves,2,1,1,4,Ocasional
1062,74,4,6738.21,Bárbara Nunes,2,2,3,7,Regular
1063,66,4,1973.15,Melina Aparecida,2,2,1,5,Ocasional
1064,22,5,3359.6,Giovanna Ferreira,3,3,2,8,Regular
1065,44,2,2712.79,Dr. Davi Miguel da Mota,2,1,2,5,Ocasional
1066,43,6,4758.66,Valentina da Luz,3,3,3,9,Regular
1067,77,5,1796.44,Srta. Isabel Brito,2,3,1,6,Ocasional
1068,40,6,6035.82,Cauã Cavalcanti,3,3,3,9,Regular
1069,75,1,4483.42,Srta. Melina Teixeira,2,1,3,6,Ocasional
1070,32,2,5018.0599999999995,Gael Henrique da Cunha,3,1,3,7,Regular
1071,23,6,7705.33,Evelyn Borges,3,3,4,10,VIP
1072,25,7,5076.1,Ísis Barbosa,3,4,3,10,VIP
1073,5,4,2039.1699999999998,Dr. Davi Miguel Azevedo,4,2,1,7,Regular
1074,86,5,4911.5599999999995,Letícia Brito,2,3,3,8,Regular
1075,40,6,8553.69,Mathias Santos,3,3,4,10,VIP
1076,70,7,6655.95,Ana Laura Nogueira,2,4,3,9,Regular
1077,64,4,3410.69,Lucas Gabriel Teixeira,2,2,2,6,Ocasional
1078,31,4,7160.19,Ana Carolina Ferreira,3,2,3,8,Regular
1079,307,1,516.54,Theo Montenegro,1,1,1,3,Inativo
1080,2,5,3569.46,Gael Henrique Nascimento,4,3,2,9,Regular
1081,42,3,2885.9399999999996,Carolina Lopes,3,1,2,6,Ocasional
1082,32,9,9348.16,Dr. Benjamin da Costa,3,4,4,11,VIP
1083,82,1,1068.88,Ana Clara Albuquerque,2,1,1,4,Ocasional
1084,63,6,6862.59,Dr. Joaquim da Rocha,2,3,3,8,Regular
1085,109,3,2220.15,Gabrielly Monteiro,1,1,1,3,Inativo
1086,115,2,1163.02,Sr. Benjamim Ferreira,1,1,1,3,Inativo
1087,2,4,6151.799999999999,Isabel das Neves,4,2,3,9,Regular
1088,32,7,6231.700000000001,Mirella Camargo,3,4,3,10,VIP
1089,242,3,1468.36,Bento da Mota,1,1,1,3,Inativo
1090,160,2,2505.31,Pedro Nascimento,1,1,2,4,Ocasional
1091,61,4,4739.56,Helena Sá,2,2,3,7,Regular
1092,15,4,2544.54,Dra. Laura Nascimento,4,2,2,8,Regular
1093,268,2,1456.54,Davi Lucca Albuquerque,1,1,1,3,Inativo
1094,24,5,1763.95,Luiz Miguel da Mata,3,3,1,7,Regular
1095,301,3,6283.759999999999,Alexia Martins,1,1,3,5,Ocasional
1096,62,2,518.52,João Guilherme Pimenta,2,1,1,4,Ocasional
1097,27,2,2753.47,Diogo Pinto,3,1,2,6,Ocasional
1098,2,9,10236.220000000001,Luiza Aparecida,4,4,4,12,VIP
1099,16,4,6095.12,Isabela Ferreira,4,2,3,9,Regular
1100,162,4,4186.27,Dr. Oliver Barbosa,1,2,2,5,Ocasional
1101,13,9,12475.82,Maria Fernanda Melo,4,4,4,12,VIP
1102,166,2,1015.15,Levi Moraes,1,1,1,3,Inativo
1103,55,4,4944.860000000001,Breno Câmara,2,2,3,7,Regular
1104,12,7,4248.17,Maysa Dias,4,4,2,10,VIP
1105,59,3,1846.29,Srta. Isabella Macedo,2,1,1,4,Ocasional
1106,6,4,2926.8599999999997,Pietro Viana,4,2,2,8,Regular
1107,68,5,9713.23,Cecilia Pereira,2,3,4,9,Regular
1108,44,4,3501.0,Thales Pires,2,2,2,6,Ocasional
1109,220,2,1311.58,Olivia Souza,1,1,1,3,Inativo
1110,48,4,2800.36,Théo Moura,2,2,2,6,Ocasional
1111,31,5,8315.55,Lucca Fernandes,3,3,4,10,VIP
1112,167,6,13635.220000000001,Lavínia Sá,1,3,4,8,Regular
1113,20,4,11198.1,Antonella Cassiano,3,2,4,9,Regular
1114,37,6,8618.73,Dra. Lara Vargas,3,3,4,10,VIP
1115,4,2,223.92000000000002,Sophia Lima,4,1,1,6,Ocasional
1116,17,3,6625.82,Srta. Marina Moreira,4,1,3,8,Regular
1117,44,2,189.89,Heloisa Cavalcante,2,1,1,4,Ocasional
1118,21,5,7335.17,Eloá Alves,3,3,4,10,VIP
1119,6,4,2923.2,Sr. João Miguel Oliveira,4,2,2,8,Regular
1120,49,3,4205.91,Dra. Bárbara Macedo,2,1,2,5,Ocasional
1121,210,2,1038.94,Sr. Henry Siqueira,1,1,1,3,Inativo
1122,168,5,3697.12,Ana Sophia Santos,1,3,2,6,Ocasional
1123,20,6,2255.61,Ana Carolina Porto,3,3,1,7,Regular
1124,308,2,2377.56,Ester Siqueira,1,1,2,4,Ocasional
1125,18,7,7654.58,Pedro Henrique Azevedo,4,4,4,12,VIP
1126,79,4,1035.41,Maria Helena Pires,2,2,1,5,Ocasional
1127,5,7,2388.14,Ryan Mendonça,4,4,2,10,VIP
1128,12,7,10072.92,Otto Machado,4,4,4,12,VIP
1129,206,3,2032.17,Carolina Vasconcelos,1,1,1,3,Inativo
1130,7,4,2506.33,Nicolas Araújo,4,2,2,8,Regular
1131,91,2,3884.14,Ryan Siqueira,1,1,2,4,Ocasional
1132,26,4,1455.11,Vitor Gabriel Costela,3,2,1,6,Ocasional
1133,157,1,723.25,Lucas Gabriel Fogaça,1,1,1,3,Inativo
1134,69,8,15988.14,Vitor Gabriel Gonçalves,2,4,4,10,VIP
1135,13,3,4164.29,Arthur Miguel Almeida,4,1,2,7,Regular
1137,45,5,6579.38,Dra. Maria Vitória Almeida,2,3,3,8,Regular
1138,19,7,3836.12,Evelyn Pereira,4,4,2,10,VIP
1139,35,7,11289.68,João Rezende,3,4,4,11,VIP
1140,88,4,4630.94,Larissa Sampaio,1,2,3,6,Ocasional
1141,25,9,8680.85,Apollo Gonçalves,3,4,4,11,VIP
1142,293,2,260.94,Antonella Brito,1,1,1,3,Inativo
1143,9,4,2682.46,Stephany Silveira,4,2,2,8,Regular
1144,16,4,7065.15,Arthur Miguel Duarte,4,2,3,9,Regular
1145,48,4,3595.99,Sara Dias,2,2,2,6,Ocasional
1146,28,4,4779.4800000000005,Cauã Lima,3,2,3,8,Regular
1147,46,2,4463.8099999999995,Pedro Lucas Camargo,2,1,3,6,Ocasional
1148,4,5,5532.33,Juan Campos,4,3,3,10,VIP
1149,8,4,1776.63,Eloah Casa Grande,4,2,1,7,Regular
1150,80,4,7883.17,Sr. Enzo Moura,2,2,4,8,Regular
1151,9,3,6089.06,Leonardo Sampaio,4,1,3,8,Regular
1152,28,4,3255.13,Eduarda Azevedo,3,2,2,7,Regular
1153,22,7,9855.439999999999,Dr. José Miguel Novais,3,4,4,11,VIP
1154,129,2,4120.21,Cauã Cardoso,1,1,2,4,Ocasional
1155,91,5,2588.97,Henrique Borges,1,3,2,6,Ocasional
1156,10,4,4622.49,Davi Miguel Moraes,4,2,3,9,Regular
1157,15,8,10252.689999999999,Maria Júlia Garcia,4,4,4,12,VIP
1158,4,7,5487.87,Hadassa Cavalcante,4,4,3,11,VIP
1159,61,7,7431.88,Maya Rezende,2,4,4,10,VIP
1160,55,8,8884.990000000002,Mateus Freitas,2,4,4,10,VIP
1161,16,8,7280.35,Sr. Léo da Cunha,4,4,3,11,VIP
1162,52,4,4488.55,Dra. Isis da Mota,2,2,3,7,Regular
1163,90,3,948.14,Ísis Caldeira,1,1,1,3,Inativo
1164,37,10,19908.43,Bryan Leão,3,4,4,11,VIP
1165,183,4,8740.14,Gael Rezende,1,2,4,7,Regular
1166,194,1,75.11,Alice Rios,1,1,1,3,Inativo
1167,107,5,8953.15,Clara Siqueira,1,3,4,8,Regular
1168,149,5,6978.49,Alexandre das Neves,1,3,3,7,Regular
1169,15,10,16866.43,Fernando Siqueira,4,4,4,12,VIP
1170,41,2,2476.7,Marcelo Marques,3,1,2,6,Ocasional
1171,34,5,10035.369999999999,Benjamim Garcia,3,3,4,10,VIP
1172,35,9,9935.71,Felipe da Rocha,3,4,4,11,VIP
1173,14,4,6909.34,Milena Pires,4,2,3,9,Regular
1174,44,4,4184.45,Sra. Manuella Ramos,2,2,2,6,Ocasional
1175,40,6,2923.51,Ravi Lucca da Luz,3,3,2,8,Regular
1176,15,10,11527.57,Dr. Marcos Vinicius Ribeiro,4,4,4,12,VIP
1177,29,4,6926.77,Sr. Francisco Fogaça,3,2,3,8,Regular
1178,7,2,690.94,Maya Siqueira,4,1,1,6,Ocasional
1179,19,4,8613.55,Asafe da Conceição,4,2,4,10,VIP
1180,1,10,18764.04,Vinicius Costa,4,4,4,12,VIP
1181,10,2,2385.2,Luiz Felipe Marques,4,1,2,7,Regular
1182,5,4,9469.8,Francisco da Costa,4,2,4,10,VIP
1183,57,2,1105.3700000000001,Sr. Rhavi Castro,2,1,1,4,Ocasional
1184,22,5,10698.759999999998,Isabelly Teixeira,3,3,4,10,VIP
1185,54,3,4810.5199999999995,Otávio Peixoto,2,1,3,6,Ocasional
1186,61,4,2949.75,Emanuelly Vargas,2,2,2,6,Ocasional
1187,142,1,222.02,Ian Carvalho,1,1,1,3,Inativo
1189,53,2,399.54,Bianca Martins,2,1,1,4,Ocasional
1190,34,1,5950.45,Maria Isis Rodrigues,3,1,3,7,Regular
1191,49,3,2825.32,Dra. Bruna Pereira,2,1,2,5,Ocasional
1192,166,3,783.3199999999999,Yasmin Teixeira,1,1,1,3,Inativo
1193,4,5,8499.32,Théo Pimenta,4,3,4,11,VIP
1194,177,5,14899.43,Léo da Cunha,1,3,4,8,Regular
1195,46,6,11982.33,Dr. Antony Machado,2,3,4,9,Regular
1196,19,11,9054.9,Erick Barros,4,4,4,12,VIP
1197,23,8,8804.22,Dra. Isabelly Siqueira,3,4,4,11,VIP
1198,45,4,3707.7000000000003,Beatriz Garcia,2,2,2,6,Ocasional
1199,26,2,3080.8,Anna Liz Lopes,3,1,2,6,Ocasional
1200,28,3,4710.16,Benicio Freitas,3,1,3,7,Regular
1201,99,5,3264.1099999999997,Murilo Cirino,1,3,2,6,Ocasional
1203,27,4,2283.17,Dra. Natália Pastor,3,2,2,7,Regular
1204,77,7,7202.4400000000005,Dr. Pedro Miguel Cassiano,2,4,3,9,Regular
1205,60,4,4300.25,Bruno Pires,2,2,2,6,Ocasional
1206,89,3,6640.79,Levi Machado,1,1,3,5,Ocasional
1207,29,2,456.0,Alícia Sá,3,1,1,5,Ocasional
1208,25,5,12240.76,Calebe Gonçalves,3,3,4,10,VIP
1209,100,5,5289.67,Sra. Maria Luísa Fogaça,1,3,3,7,Regular
1210,18,2,751.3299999999999,Luiza Montenegro,4,1,1,6,Ocasional
1211,52,5,3742.9300000000003,Murilo da Paz,2,3,2,7,Regular
1212,101,5,4022.83,Mariah Leão,1,3,2,6,Ocasional
1213,4,7,13638.53,Nicolas Almeida,4,4,4,12,VIP
1214,100,4,3306.5,Maria Julia Novaes,1,2,2,5,Ocasional
1215,292,1,1157.69,Lorenzo Cardoso,1,1,1,3,Inativo
1216,3,3,1425.91,Felipe Martins,4,1,1,6,Ocasional
1217,191,5,4677.6900000000005,Arthur Gabriel Rodrigues,1,3,3,7,Regular
1218,58,2,1833.43,Dra. Bárbara Silva,2,1,1,4,Ocasional
1219,6,9,8431.68,Srta. Maria Clara Guerra,4,4,4,12,VIP
1220,45,5,2434.51,Brenda Silveira,2,3,2,7,Regular
1221,11,6,5009.16,Calebe Farias,4,3,3,10,VIP
1222,17,6,5985.2300000000005,Joana Nunes,4,3,3,10,VIP
1223,20,7,12987.98,Sra. Lorena Silva,3,4,4,11,VIP
1224,70,3,4462.99,Srta. Clara Pereira,2,1,3,6,Ocasional
1225,147,6,3188.65,José Pedro Fonseca,1,3,2,6,Ocasional
1226,113,8,10649.51,Dr. Marcos Vinicius Mendonça,1,4,4,9,Regular
1227,23,1,766.4,Sr. Leonardo Costela,3,1,1,5,Ocasional
1228,31,2,2692.0,Alice Souza,3,1,2,6,Ocasional
1229,260,3,3259.9,Sr. João Gabriel Novaes,1,1,2,4,Ocasional
1230,158,2,634.46,Joaquim da Conceição,1,1,1,3,Inativo
1231,60,7,8104.01,Srta. Caroline Moreira,2,4,4,10,VIP
1232,31,4,1736.41,Liam Vieira,3,2,1,6,Ocasional
1233,206,1,6400.5,Helena Peixoto,1,1,3,5,Ocasional
1234,136,2,14368.23,Mirella Abreu,1,1,4,6,Ocasional
1235,4,6,7174.63,Kaique da Luz,4,3,3,10,VIP
1236,105,5,8011.76,Ryan Abreu,1,3,4,8,Regular
1237,62,5,11836.61,Calebe Macedo,2,3,4,9,Regular
1238,18,3,984.76,Dr. Cauã Rodrigues,4,1,1,6,Ocasional
1239,137,2,2262.76,Emanuel Pimenta,1,1,1,3,Inativo
1240,93,4,1736.21,Liz Freitas,1,2,1,4,Ocasional
1241,102,1,618.16,Maria Júlia Teixeira,1,1,1,3,Inativo
1242,34,3,3159.79,Rafael Vargas,3,1,2,6,Ocasional
1244,206,2,3842.29,Dr. Ravy Aparecida,1,1,2,4,Ocasional
1245,9,7,5322.17,Carlos Eduardo Araújo,4,4,3,11,VIP
1246,5,6,1894.1999999999998,Luan Vasconcelos,4,3,1,8,Regular
1247,78,5,3368.59,Luan Oliveira,2,3,2,7,Regular
1248,57,7,8971.09,Dr. Pietro Souza,2,4,4,10,VIP
1249,77,4,3396.0299999999997,Joana da Cunha,2,2,2,6,Ocasional
1250,159,6,3588.5600000000004,Vinícius Araújo,1,3,2,6,Ocasional
1251,3,6,3895.24,Sr. Breno Nunes,4,3,2,9,Regular
1252,2,7,15164.93,Esther Sá,4,4,4,12,VIP
1253,19,9,4064.7300000000005,Fernando Ramos,4,4,2,10,VIP
1254,206,3,7171.379999999999,Allana Albuquerque,1,1,3,5,Ocasional
1255,172,4,6167.79,Natália Rezende,1,2,3,6,Ocasional
1256,37,4,2841.34,Fernando Brito,3,2,2,7,Regular
1257,36,10,6269.86,Giovanna Costa,3,4,3,10,VIP
1258,52,5,3327.9900000000002,Camila Garcia,2,3,2,7,Regular
1259,30,7,7080.9400000000005,Mateus Pastor,3,4,3,10,VIP
1260,15,7,4661.74,Maria Alice Souza,4,4,3,11,VIP
1261,24,6,8086.110000000001,Allana Abreu,3,3,4,10,VIP
1262,127,3,791.88,Letícia da Conceição,1,1,1,3,Inativo
1263,111,4,1306.8,Sr. Diego da Cruz,1,2,1,4,Ocasional
1264,72,4,5942.84,Bento Peixoto,2,2,3,7,Regular
1265,18,6,2777.0,Clarice Sousa,4,3,2,9,Regular
1266,50,4,3561.57,Maria Fernanda da Luz,2,2,2,6,Ocasional
1267,94,3,2621.0,Vitor Hugo Garcia,1,1,2,4,Ocasional
1268,25,7,11181.93,Renan Martins,3,4,4,11,VIP
1269,15,6,7057.79,Davi Lucas Duarte,4,3,3,10,VIP
1270,176,3,1982.83,Henry Gabriel Ribeiro,1,1,1,3,Inativo
1271,3,5,6068.55,Kevin Farias,4,3,3,10,VIP
1272,86,2,3132.99,Clara Pacheco,2,1,2,5,Ocasional
1273,12,4,12588.890000000001,Diego Porto,4,2,4,10,VIP
1274,7,4,6650.379999999999,Sr. Nathan Machado,4,2,3,9,Regular
1275,48,7,8210.65,Maitê Fernandes,2,4,4,10,VIP
1276,39,7,4443.46,Julia Azevedo,3,4,3,10,VIP
1277,191,3,2580.84,Yan Silva,1,1,2,4,Ocasional
1278,48,2,3075.2200000000003,Evelyn Casa Grande,2,1,2,5,Ocasional
1279,55,2,900.95,Ana Julia Nascimento,2,1,1,4,Ocasional
1280,59,9,9737.76,Heloisa Sá,2,4,4,10,VIP
1281,88,4,343.87,Laís Gomes,1,2,1,4,Ocasional
1282,13,5,5089.41,Leonardo Costela,4,3,3,10,VIP
1283,260,3,5165.889999999999,Matteo Viana,1,1,3,5,Ocasional
1284,94,1,635.95,João Guilherme Carvalho,1,1,1,3,Inativo
1285,8,6,8414.07,Luan Albuquerque,4,3,4,11,VIP
1286,50,5,2649.84,Pedro Lucas da Rosa,2,3,2,7,Regular
1287,108,2,770.0699999999999,Asafe Garcia,1,1,1,3,Inativo
1288,4,7,5102.22,Lavínia Câmara,4,4,3,11,VIP
1289,15,5,1886.3700000000001,João Lucas Silveira,4,3,1,8,Regular
1290,165,1,2535.93,Isabelly Pacheco,1,1,2,4,Ocasional
1291,22,6,5765.13,Maria Flor Pereira,3,3,3,9,Regular
1292,17,9,10284.66,Luiz Miguel Pacheco,4,4,4,12,VIP
1293,4,4,2354.0299999999997,Stephany Andrade,4,2,2,8,Regular
1294,27,6,5076.47,Luísa Brito,3,3,3,9,Regular
1295,72,2,2637.68,João Guilherme Machado,2,1,2,5,Ocasional
1296,5,3,1046.87,Luna Sousa,4,1,1,6,Ocasional
1297,200,3,3135.07,Srta. Luiza das Neves,1,1,2,4,Ocasional
1298,21,3,2207.54,Gabriela da Luz,3,1,1,5,Ocasional
1299,41,5,1207.42,Gabriel Pacheco,3,3,1,7,Regular
1300,18,10,12916.75,Caleb Borges,4,4,4,12,VIP
1301,5,5,3850.48,Bella Sousa,4,3,2,9,Regular
1302,26,10,21211.78,Apollo Monteiro,3,4,4,11,VIP
1303,43,6,7044.1900000000005,Antônio Pimenta,3,3,3,9,Regular
1304,43,5,1044.28,Maria Liz Pires,3,3,1,7,Regular
1305,186,5,10860.22,Liam Nogueira,1,3,4,8,Regular
1306,21,5,7234.030000000001,Thiago Santos,3,3,3,9,Regular
1307,56,2,3314.7,Heloisa Martins,2,1,2,5,Ocasional
1308,44,4,4882.290000000001,Antônio Novais,2,2,3,7,Regular
1309,58,4,4244.42,João Guilherme Nunes,2,2,2,6,Ocasional
1310,74,6,17099.89,Vitor Gabriel Sampaio,2,3,4,9,Regular
1311,16,7,8433.79,Benjamim Silva,4,4,4,12,VIP
1312,157,5,14193.51,Emanuelly Cirino,1,3,4,8,Regular
1313,152,4,1567.1299999999999,Maria Julia Jesus,1,2,1,4,Ocasional
1314,44,3,2441.44,Sra. Isis Monteiro,2,1,2,5,Ocasional
1315,71,5,6897.9,Anna Liz Fernandes,2,3,3,8,Regular
1316,21,5,6117.4,Sr. Enzo Gabriel Abreu,3,3,3,9,Regular
1317,22,3,4554.35,Erick Correia,3,1,3,7,Regular
1318,8,3,1554.3,Pedro Lucas Santos,4,1,1,6,Ocasional
1319,2,6,3100.7400000000002,Leonardo da Rocha,4,3,2,9,Regular
1320,64,5,7639.54,Lucca Marques,2,3,4,9,Regular
1321,31,4,3426.99,Samuel Correia,3,2,2,7,Regular
1322,12,4,3640.92,Vicente Borges,4,2,2,8,Regular
1323,27,3,6999.43,Sr. Pietro Teixeira,3,1,3,7,Regular
1324,13,6,5287.56,Bella Duarte,4,3,3,10,VIP
1325,62,7,13022.130000000001,Srta. Vitória Aparecida,2,4,4,10,VIP
1326,4,7,3714.04,Ana Aragão,4,4,2,10,VIP
1327,18,4,1286.8600000000001,Emanuelly Moraes,4,2,1,7,Regular
1328,252,3,2909.62,Srta. Sabrina Costela,1,1,2,4,Ocasional
1329,124,5,2248.15,Luísa Cavalcanti,1,3,1,5,Ocasional
1330,63,1,1228.06,Joana Lima,2,1,1,4,Ocasional
1331,46,6,5944.23,Gabriel Vasconcelos,2,3,3,8,Regular
1332,86,3,3720.67,Brayan Porto,2,1,2,5,Ocasional
1333,2,6,13176.27,Sra. Maria Laura da Paz,4,3,4,11,VIP
1334,136,3,2755.1000000000004,Caio Novais,1,1,2,4,Ocasional
1335,26,3,1645.54,Arthur Miguel Gomes,3,1,1,5,Ocasional
1336,25,2,1581.04,Cecília Macedo,3,1,1,5,Ocasional
1337,55,4,6112.22,Eduardo Fernandes,2,2,3,7,Regular
1338,39,10,14852.770000000002,Thiago Azevedo,3,4,4,11,VIP
1339,164,5,8420.18,Joaquim Pereira,1,3,4,8,Regular
1340,196,3,2226.74,Yasmin Almeida,1,1,1,3,Inativo
1341,252,3,992.0,Agatha Nunes,1,1,1,3,Inativo
1342,21,5,3692.8500000000004,Olívia Oliveira,3,3,2,8,Regular
1343,88,6,4438.5599999999995,Luiz Felipe Porto,1,3,3,7,Regular
1344,27,6,2377.05,Mathias da Cunha,3,3,2,8,Regular
1345,111,3,616.23,Dra. Heloísa Guerra,1,1,1,3,Inativo
1346,1,3,1492.1599999999999,Nicole Fonseca,4,1,1,6,Ocasional
1347,47,5,4648.78,Evelyn Siqueira,2,3,3,8,Regular
1348,180,3,792.8,Milena da Rosa,1,1,1,3,Inativo
1349,55,2,2855.8599999999997,Marina Cirino,2,1,2,5,Ocasional
1350,50,7,8351.55,Daniela Ramos,2,4,4,10,VIP
1351,22,7,6892.02,Srta. Raquel Dias,3,4,3,10,VIP
1352,35,6,5308.36,Lucas Borges,3,3,3,9,Regular
1353,1,3,3559.24,Melissa Melo,4,1,2,7,Regular
1354,14,7,11199.86,Maria Luísa Castro,4,4,4,12,VIP
1355,23,6,10556.85,Aylla Sá,3,3,4,10,VIP
1356,203,4,1144.0800000000002,Sra. Maysa Pacheco,1,2,1,4,Ocasional
1357,10,5,3458.1499999999996,Kaique Rocha,4,3,2,9,Regular
1358,207,2,465.8,Luiz Gustavo Pereira,1,1,1,3,Inativo
1359,60,5,1577.83,Vicente Alves,2,3,1,6,Ocasional
1360,91,4,3510.2200000000003,Maitê Aparecida,1,2,2,5,Ocasional
1361,34,6,7309.67,Allana da Rosa,3,3,3,9,Regular
1362,18,5,6924.92,Dr. Nicolas Santos,4,3,3,10,VIP
1363,54,2,1224.94,Antonella Rios,2,1,1,4,Ocasional
1364,18,4,5920.55,Eduardo Oliveira,4,2,3,9,Regular
1365,60,5,5054.77,Ana Sophia Cassiano,2,3,3,8,Regular
1366,12,6,10092.49,Guilherme Souza,4,3,4,11,VIP
1367,53,6,8406.83,Gustavo Henrique Aragão,2,3,4,9,Regular
1368,24,7,5121.9400000000005,Ester Melo,3,4,3,10,VIP
1369,112,5,2787.71,Diego Nogueira,1,3,2,6,Ocasional
1370,14,4,887.76,Enrico Gonçalves,4,2,1,7,Regular
1371,113,4,5728.910000000001,José da Paz,1,2,3,6,Ocasional
1372,8,8,6073.57,Anna Liz Rocha,4,4,3,11,VIP
1373,11,6,3368.04,Sr. João Siqueira,4,3,2,9,Regular
1374,257,3,2648.77,Srta. Heloísa Pastor,1,1,2,4,Ocasional
1375,79,2,296.35,Nicole Martins,2,1,1,4,Ocasional
1376,9,2,1946.56,Clarice Guerra,4,1,1,6,Ocasional
1377,15,4,2103.47,Clarice da Mata,4,2,1,7,Regular
1378,241,3,1559.73,Lara da Conceição,1,1,1,3,Inativo
1379,57,3,1406.98,Ana Liz Fogaça,2,1,1,4,Ocasional
1380,108,2,1561.8000000000002,Helena Leão,1,1,1,3,Inativo
1381,7,5,4406.3,Mariane Pimenta,4,3,3,10,VIP
1382,1,4,3496.44,Léo Nunes,4,2,2,8,Regular
1383,55,4,2839.1400000000003,Srta. Luara Porto,2,2,2,6,Ocasional
1384,60,3,11094.029999999999,Lorenzo Viana,2,1,4,7,Regular
1385,22,3,4391.75,Clara Pinto,3,1,3,7,Regular
1386,101,4,2412.61,Diego Fonseca,1,2,2,5,Ocasional
1387,150,5,4649.83,Clara Viana,1,3,3,7,Regular
1388,4,4,9349.26,Bárbara da Rocha,4,2,4,10,VIP
1389,23,9,19808.64,Kaique da Luz,3,4,4,11,VIP
1390,38,5,4648.64,Léo Martins,3,3,3,9,Regular
1391,3,4,3818.01,João Guilherme Marques,4,2,2,8,Regular
1392,92,3,5425.5,Davi Aragão,1,1,3,5,Ocasional
1393,15,8,14405.630000000001,Dr. Felipe Duarte,4,4,4,12,VIP
1394,10,8,9161.29,Srta. Sara Azevedo,4,4,4,12,VIP
1395,53,5,3744.41,Dr. Lucca Barros,2,3,2,7,Regular
1396,16,5,5323.87,Maria Laura Sales,4,3,3,10,VIP
1397,16,4,7347.04,Ian da Costa,4,2,4,10,VIP
1398,49,4,2814.97,Eduardo Carvalho,2,2,2,6,Ocasional
1399,81,2,873.96,Ana Lívia Aparecida,2,1,1,4,Ocasional
1400,25,7,9793.96,Sr. Miguel Cunha,3,4,4,11,VIP
1401,127,3,1107.3700000000001,Guilherme Sá,1,1,1,3,Inativo
1402,52,3,1211.08,Sophie Vargas,2,1,1,4,Ocasional
1403,40,2,1327.49,Guilherme Teixeira,3,1,1,5,Ocasional
1404,203,3,8625.56,Henrique Moraes,1,1,4,6,Ocasional
1405,77,5,4860.299999999999,Sra. Lunna Marques,2,3,3,8,Regular
1406,44,3,1079.75,Isadora Barbosa,2,1,1,4,Ocasional
1407,57,6,6689.69,Pedro Miguel Garcia,2,3,3,8,Regular
1408,27,5,10974.070000000002,Sra. Ana Vitória da Mota,3,3,4,10,VIP
1409,28,5,5374.860000000001,Gabrielly Campos,3,3,3,9,Regular
1410,38,4,2761.0499999999997,Júlia da Mata,3,2,2,7,Regular
1411,152,4,3313.62,Ana Andrade,1,2,2,5,Ocasional
1412,13,4,17246.22,Ana Luiza Vargas,4,2,4,10,VIP
1413,27,4,3003.76,Isaac Sales,3,2,2,7,Regular
1414,36,5,6611.15,Srta. Laura Fonseca,3,3,3,9,Regular
1415,234,1,173.51,Sr. Lorenzo Sousa,1,1,1,3,Inativo
1416,16,8,11075.74,Sabrina Rocha,4,4,4,12,VIP
1417,163,3,6148.79,Ágatha Rodrigues,1,1,3,5,Ocasional
1418,21,6,10333.810000000001,Srta. Cecilia Vieira,3,3,4,10,VIP
1419,116,5,4417.38,André da Cunha,1,3,3,7,Regular
1420,51,9,13595.2,Dr. Vicente Ribeiro,2,4,4,10,VIP
1421,80,4,1887.24,Daniela Sales,2,2,1,5,Ocasional
1422,109,4,7328.5,Sra. Isabella Sá,1,2,4,7,Regular
1423,20,6,6382.83,Dante Costela,3,3,3,9,Regular
1424,43,4,2966.57,Kaique Fernandes,3,2,2,7,Regular
1425,55,4,4454.35,Ana Cecília Rocha,2,2,3,7,Regular
1426,53,3,5352.94,Zoe Vargas,2,1,3,6,Ocasional
1427,47,5,5334.320000000001,Renan da Cunha,2,3,3,8,Regular
1428,17,8,5218.26,Ravy Andrade,4,4,3,11,VIP
1429,4,4,6025.29,Ana Montenegro,4,2,3,9,Regular
1430,65,4,1951.51,Ana Julia da Cunha,2,2,1,5,Ocasional
1431,10,3,1114.01,João Vitor Peixoto,4,1,1,6,Ocasional
1432,37,5,10977.17,Emanuelly Vargas,3,3,4,10,VIP
1433,137,3,2182.8599999999997,Heloísa Silva,1,1,1,3,Inativo
1434,60,3,7326.549999999999,Amanda Macedo,2,1,4,7,Regular
1435,26,4,5027.23,Bianca Leão,3,2,3,8,Regular
1436,12,7,10748.060000000001,Maria Alice Melo,4,4,4,12,VIP
1437,2,11,22770.42,Gael Henrique Machado,4,4,4,12,VIP
1438,27,6,2750.12,Igor Costa,3,3,2,8,Regular
1439,21,5,2533.2799999999997,Daniel Moura,3,3,2,8,Regular
1440,32,3,4121.21,Olívia Mendes,3,1,2,6,Ocasional
1441,24,4,1706.83,Carolina Moraes,3,2,1,6,Ocasional
1442,39,2,1706.8200000000002,Maria Cecília Câmara,3,1,1,5,Ocasional
1443,6,3,1794.83,Sra. Maria Júlia Machado,4,1,1,6,Ocasional
1444,58,5,6587.92,Theo Vargas,2,3,3,8,Regular
1445,31,5,4115.34,Asafe Freitas,3,3,2,8,Regular
1446,53,3,2185.41,Ravy Moraes,2,1,1,4,Ocasional
1447,32,5,3551.18,Manuela Nascimento,3,3,2,8,Regular
1448,21,4,2752.7400000000002,Sr. Gabriel Ferreira,3,2,2,7,Regular
1449,15,3,530.79,Esther Vargas,4,1,1,6,Ocasional
1450,137,4,12039.33,Stephany Cavalcanti,1,2,4,7,Regular
1451,20,4,3648.7299999999996,Sr. Theo Freitas,3,2,2,7,Regular
1452,57,6,11903.31,Brayan da Cunha,2,3,4,9,Regular
1453,158,4,4535.799999999999,Thales Marques,1,2,3,6,Ocasional
1454,58,5,4337.9,Bianca Melo,2,3,2,7,Regular
1455,31,3,1667.9499999999998,Asafe Azevedo,3,1,1,5,Ocasional
1456,204,1,2430.31,Mariana Costela,1,1,2,4,Ocasional
1457,8,4,4155.63,Pedro da Costa,4,2,2,8,Regular
1458,11,5,4393.85,Yuri Pacheco,4,3,3,10,VIP
1459,1,7,14531.25,Júlia Mendonça,4,4,4,12,VIP
1460,52,4,2651.97,Henry da Mota,2,2,2,6,Ocasional
1461,2,5,9088.72,Hadassa da Conceição,4,3,4,11,VIP
1462,22,6,10790.36,Maria Helena Almeida,3,3,4,10,VIP
1463,105,6,10441.22,Melina Pereira,1,3,4,8,Regular
1464,47,5,5590.28,Eloá Viana,2,3,3,8,Regular
1465,22,6,13679.39,Mateus Peixoto,3,3,4,10,VIP
1466,70,4,454.07000000000005,Srta. Maria Julia Oliveira,2,2,1,5,Ocasional
1467,101,2,2933.8900000000003,Luiz Fernando da Conceição,1,1,2,4,Ocasional
1468,90,7,14395.99,Vitória Costa,1,4,4,9,Regular
1469,1,9,5033.66,Yuri Aragão,4,4,3,11,VIP
1470,84,2,1209.98,Francisco da Conceição,2,1,1,4,Ocasional
1471,70,6,7587.22,Emanuelly da Paz,2,3,4,9,Regular
1472,35,6,9998.09,Carlos Eduardo da Mata,3,3,4,10,VIP
1473,2,3,6840.06,Joaquim Viana,4,1,3,8,Regular
1474,277,1,1760.31,Catarina Cavalcante,1,1,1,3,Inativo
1475,5,4,7449.98,Ravi da Cruz,4,2,4,10,VIP
1476,51,5,11299.45,Bernardo Garcia,2,3,4,9,Regular
1477,60,7,27734.859999999997,Sra. Valentina Martins,2,4,4,10,VIP
1478,73,4,993.33,Gustavo Barbosa,2,2,1,5,Ocasional
1479,19,7,16179.73,Fernanda Sá,4,4,4,12,VIP
1480,6,7,3445.76,Srta. Liz Gonçalves,4,4,2,10,VIP
1481,57,4,8126.9,Maria Fernanda Costela,2,2,4,8,Regular
1482,23,6,12787.58,Marcelo Aragão,3,3,4,10,VIP
1483,12,4,6218.59,Ana Lívia Fogaça,4,2,3,9,Regular
1484,120,4,8737.91,Júlia Araújo,1,2,4,7,Regular
1485,74,4,4454.11,Natália Ferreira,2,2,3,7,Regular
1486,30,5,4218.47,Ana Carolina Rios,3,3,2,8,Regular
1487,54,2,800.19,Gael Henrique Borges,2,1,1,4,Ocasional
1488,25,5,6094.12,Gael Leão,3,3,3,9,Regular
1489,3,2,334.94,João Siqueira,4,1,1,6,Ocasional
1490,120,4,5046.84,Natália Fernandes,1,2,3,6,Ocasional
1491,33,5,7886.950000000001,Stephany Rodrigues,3,3,4,10,VIP
1492,26,5,6172.710000000001,Sra. Ana Júlia Pastor,3,3,3,9,Regular
1493,117,4,10723.970000000001,Ravi Cassiano,1,2,4,7,Regular
1494,35,4,4663.8,Bruno da Cruz,3,2,3,8,Regular
1495,11,8,9847.26,Oliver Melo,4,4,4,12,VIP
1496,348,2,978.98,Hadassa Guerra,1,1,1,3,Inativo
1497,29,6,5470.95,Maria Flor Barros,3,3,3,9,Regular
1498,138,9,7167.91,Dom Aragão,1,4,3,8,Regular
1499,9,3,3181.7999999999997,Maria Alice Rios,4,1,2,7,Regular
1500,112,6,5596.01,Alexandre Correia,1,3,3,7,Regular
1501,38,6,5693.17,João Miguel Carvalho,3,3,3,9,Regular
1502,46,3,959.29,Arthur Gabriel Gonçalves,2,1,1,4,Ocasional
1503,187,4,3731.15,Leonardo Rios,1,2,2,5,Ocasional
1506,60,6,12259.529999999999,Sr. Matteo Correia,2,3,4,9,Regular
1507,191,4,6644.24,Luna Machado,1,2,3,6,Ocasional
1508,53,2,703.63,Srta. Alana Viana,2,1,1,4,Ocasional
1509,6,7,8703.23,Théo Pereira,4,4,4,12,VIP
1510,91,4,1820.2299999999998,Maria Cecília Silva,1,2,1,4,Ocasional
1512,42,3,6082.74,Vitor Gabriel Sá,3,1,3,7,Regular
1513,34,4,4187.45,Renan Leão,3,2,2,7,Regular
1514,110,3,1313.34,Ana Carolina da Conceição,1,1,1,3,Inativo
1515,55,7,11762.3,Isabella Gonçalves,2,4,4,10,VIP
1516,60,5,3520.93,Dra. Lorena Vargas,2,3,2,7,Regular
1517,10,7,7543.16,Luísa Cavalcanti,4,4,4,12,VIP
1518,42,4,1657.97,Alícia Brito,3,2,1,6,Ocasional
1519,42,4,2219.0,Gabrielly Siqueira,3,2,1,6,Ocasional
1520,54,4,1357.04,Davi Abreu,2,2,1,5,Ocasional
1521,42,8,20757.61,Theodoro Vargas,3,4,4,11,VIP
1522,168,2,462.13,Sr. Mathias Correia,1,1,1,3,Inativo
1523,132,6,7069.7,Dra. Evelyn Mendes,1,3,3,7,Regular
1524,20,4,6344.16,Enzo Correia,3,2,3,8,Regular
1525,48,8,8630.66,Natália Gomes,2,4,4,10,VIP
1526,11,4,1487.3200000000002,Maria Fernanda Rezende,4,2,1,7,Regular
1527,221,3,1386.53,Bruna Pastor,1,1,1,3,Inativo
1528,49,6,10647.52,Sr. Leonardo Nascimento,2,3,4,9,Regular
1529,23,4,2952.92,José Pedro Garcia,3,2,2,7,Regular
1530,144,4,9313.57,Kaique Jesus,1,2,4,7,Regular
1531,7,3,6092.1900000000005,Beatriz Fonseca,4,1,3,8,Regular
1532,10,5,5528.4,Igor Aragão,4,3,3,10,VIP
1533,28,5,8597.8,Leonardo Leão,3,3,4,10,VIP
1534,41,6,6043.38,Alana Caldeira,3,3,3,9,Regular
1535,184,3,1635.49,Isadora Barros,1,1,1,3,Inativo
1536,33,4,6348.11,Davi Lucas Cavalcante,3,2,3,8,Regular
1537,39,5,12250.35,Pedro Cunha,3,3,4,10,VIP
1538,18,3,991.33,Laura da Mata,4,1,1,6,Ocasional
1539,36,7,7446.68,Esther Souza,3,4,4,11,VIP
1540,5,4,2887.26,Igor da Cruz,4,2,2,8,Regular
1541,17,7,6725.82,Agatha Rezende,4,4,3,11,VIP
1542,53,3,768.97,Davi Freitas,2,1,1,4,Ocasional
1544,9,5,3391.26,Bento Viana,4,3,2,9,Regular
1545,27,5,10015.3,João Miguel da Mota,3,3,4,10,VIP
1546,29,4,7656.92,Marcela da Rosa,3,2,4,9,Regular
1547,272,1,5907.97,Pedro Lucas Carvalho,1,1,3,5,Ocasional
1548,36,6,10432.39,Daniel da Mata,3,3,4,10,VIP
1549,91,5,1792.95,Isaque da Paz,1,3,1,5,Ocasional
1550,179,4,2495.68,Dom Almeida,1,2,2,5,Ocasional
1551,15,7,8318.89,Sra. Isis Sampaio,4,4,4,12,VIP
1552,77,4,8562.09,Luan Aparecida,2,2,4,8,Regular
1553,48,6,4555.26,Breno Caldeira,2,3,3,8,Regular
1554,61,4,4481.21,Srta. Bella Rodrigues,2,2,3,7,Regular
1555,41,4,3662.64,Anthony Pastor,3,2,2,7,Regular
1556,22,5,6512.4400000000005,Bárbara Borges,3,3,3,9,Regular
1557,28,3,3421.97,Srta. Rebeca Cunha,3,1,2,6,Ocasional
1558,109,1,303.5,Sra. Maria Alice Sá,1,1,1,3,Inativo
1559,31,5,6675.62,Alícia Rios,3,3,3,9,Regular
1560,17,3,9178.67,Gael Henrique Cardoso,4,1,4,9,Regular
1561,3,8,13353.789999999999,Srta. Maria Clara Pires,4,4,4,12,VIP
1562,30,4,9892.45,Emanuella Rodrigues,3,2,4,9,Regular
1563,254,1,4830.24,Heloísa Sampaio,1,1,3,5,Ocasional
1564,10,2,1821.6299999999999,Helena Machado,4,1,1,6,Ocasional
1565,39,8,17907.059999999998,Srta. Fernanda Guerra,3,4,4,11,VIP
1566,118,5,3066.15,Ian Sousa,1,3,2,6,Ocasional
1567,11,5,3525.8500000000004,Davi Lucas da Costa,4,3,2,9,Regular
1568,225,3,2078.56,Zoe Borges,1,1,1,3,Inativo
1569,6,2,4007.5299999999997,Davi Miguel Vieira,4,1,2,7,Regular
1570,64,6,4435.23,Lorenzo Marques,2,3,3,8,Regular
1571,10,6,8830.72,Amanda Silveira,4,3,4,11,VIP
1572,12,7,8617.16,Pedro Lucas Viana,4,4,4,12,VIP
1573,60,7,4395.25,Thiago Ramos,2,4,3,9,Regular
1574,30,5,17749.18,Laura Mendonça,3,3,4,10,VIP
1575,78,3,3509.67,Maya Martins,2,1,2,5,Ocasional
1576,97,3,3999.18,Luiz Miguel Silveira,1,1,2,4,Ocasional
1577,32,4,3851.7700000000004,Thomas da Conceição,3,2,2,7,Regular
1578,106,4,5460.24,Yuri Silva,1,2,3,6,Ocasional
1579,25,3,1861.65,Natália Pinto,3,1,1,5,Ocasional
1580,51,4,6465.37,Davi Gonçalves,2,2,3,7,Regular
1581,53,1,1598.07,Emanuelly Novaes,2,1,1,4,Ocasional
1582,34,8,5815.83,Ana Luiza Guerra,3,4,3,10,VIP
1583,98,5,9347.74,Lorena Jesus,1,3,4,8,Regular
1584,137,2,910.1800000000001,Marina Cunha,1,1,1,3,Inativo
1585,37,5,5213.33,Maria Julia Castro,3,3,3,9,Regular
1586,119,4,9919.029999999999,Sr. Juan Correia,1,2,4,7,Regular
1587,64,1,306.35,Théo Oliveira,2,1,1,4,Ocasional
1588,5,6,3545.0299999999997,Stella Cavalcanti,4,3,2,9,Regular
1589,107,3,5446.71,Benjamin da Rocha,1,1,3,5,Ocasional
1590,23,4,4163.849999999999,Srta. Maria Laura Siqueira,3,2,2,7,Regular
1591,10,4,7817.48,Camila Nogueira,4,2,4,10,VIP
1592,28,2,2877.38,Davi Luiz Guerra,3,1,2,6,Ocasional
1593,201,4,7027.6,Sara Teixeira,1,2,3,6,Ocasional
1594,253,4,5117.17,Anthony Cirino,1,2,3,6,Ocasional
1595,148,3,2114.18,Carolina Peixoto,1,1,1,3,Inativo
1596,48,8,12723.53,Dante Silveira,2,4,4,10,VIP
1597,89,4,1239.19,Sr. Benjamin Barbosa,1,2,1,4,Ocasional
1598,84,3,2948.04,Vitória Mendes,2,1,2,5,Ocasional
1599,110,2,2585.6400000000003,Thiago Casa Grande,1,1,2,4,Ocasional
1600,16,2,1864.96,Juan Cardoso,4,1,1,6,Ocasional
1601,71,6,5021.45,Maria Laura Lima,2,3,3,8,Regular
1602,43,4,6847.76,Asafe Correia,3,2,3,8,Regular
1603,20,2,658.52,Matheus Cassiano,3,1,1,5,Ocasional
1604,21,6,8925.38,Luigi Fogaça,3,3,4,10,VIP
1605,107,4,2448.86,Raquel Lima,1,2,2,5,Ocasional
1606,35,4,5175.84,Alana Vieira,3,2,3,8,Regular
1608,86,6,4861.969999999999,Dr. Antony Pereira,2,3,3,8,Regular
1609,19,5,4055.67,Rael da Cunha,4,3,2,9,Regular
1610,63,4,3003.9,Laís Novaes,2,2,2,6,Ocasional
1611,24,7,11147.28,Isadora Casa Grande,3,4,4,11,VIP
1612,50,2,1956.8400000000001,Francisco Vasconcelos,2,1,1,4,Ocasional
1613,193,2,4059.57,Nicolas Pinto,1,1,2,4,Ocasional
1614,6,5,2266.3399999999997,Pedro Miguel Cavalcanti,4,3,2,9,Regular
1615,177,2,1118.28,Maria Cecília Rezende,1,1,1,3,Inativo
1616,48,5,11678.529999999999,Dr. Dante Casa Grande,2,3,4,9,Regular
1617,25,12,9339.7,Clara Lopes,3,4,4,11,VIP
1618,78,6,7050.2,Anthony Gabriel Novais,2,3,3,8,Regular
1619,44,2,459.71999999999997,Dr. Dante da Cunha,2,1,1,4,Ocasional
1620,3,5,3949.4700000000003,Thomas da Mata,4,3,2,9,Regular
1621,21,5,2043.18,Maya Peixoto,3,3,1,7,Regular
1622,24,5,3299.28,Bruno Rios,3,3,2,8,Regular
1623,9,4,6344.14,Lara Barros,4,2,3,9,Regular
1624,12,6,10661.48,Melina Ramos,4,3,4,11,VIP
1625,147,5,2404.65,Maysa Macedo,1,3,2,6,Ocasional
1626,20,6,10033.42,Caroline Peixoto,3,3,4,10,VIP
1627,3,10,8881.93,Maria Isis Aragão,4,4,4,12,VIP
1628,17,3,3992.33,Bernardo Correia,4,1,2,7,Regular
1629,62,3,1446.85,Guilherme Ferreira,2,1,1,4,Ocasional
1630,93,3,2261.48,Cauã Barros,1,1,1,3,Inativo
1631,214,6,3700.64,Luiza Cardoso,1,3,2,6,Ocasional
1632,20,5,12961.89,Yago da Rocha,3,3,4,10,VIP
1633,42,5,7448.45,Laís Moraes,3,3,4,10,VIP
1634,35,8,9286.99,Cauã Gonçalves,3,4,4,11,VIP
1635,353,1,1603.96,Francisco Barbosa,1,1,1,3,Inativo
1636,28,3,2193.13,Mariah Cavalcante,3,1,1,5,Ocasional
1637,25,5,2353.06,Emanuelly Nogueira,3,3,2,8,Regular
1638,76,5,7707.03,Ísis Silveira,2,3,4,9,Regular
1639,154,4,3874.87,Isabela Guerra,1,2,2,5,Ocasional
1640,16,7,6028.12,Fernando Câmara,4,4,3,11,VIP
1641,19,7,9671.849999999999,João Guerra,4,4,4,12,VIP
1642,133,5,10950.94,Maria Laura Marques,1,3,4,8,Regular
1643,14,8,2222.98,Yago Almeida,4,4,1,9,Regular
1644,22,6,12511.880000000001,Ágatha Lopes,3,3,4,10,VIP
1645,96,4,3105.67,Antonella da Paz,1,2,2,5,Ocasional
1646,72,4,6524.95,Sr. Isaac Nogueira,2,2,3,7,Regular
1647,31,3,2909.62,Apollo Pimenta,3,1,2,6,Ocasional
1648,24,8,10666.65,Sabrina Pimenta,3,4,4,11,VIP
1649,321,1,701.52,Liam Moreira,1,1,1,3,Inativo
1650,41,7,10835.54,Isaac Freitas,3,4,4,11,VIP
1651,9,7,14268.97,Dr. Arthur Miguel Alves,4,4,4,12,VIP
1652,38,4,7036.91,Dr. José Cirino,3,2,3,8,Regular
1653,190,2,1977.47,Laís Cirino,1,1,1,3,Inativo
1654,52,3,3846.4700000000003,Yago Oliveira,2,1,2,5,Ocasional
1655,46,4,783.94,Dr. Felipe Fernandes,2,2,1,5,Ocasional
1656,136,1,629.92,Maria Eduarda Caldeira,1,1,1,3,Inativo
1657,31,6,12167.34,Stella da Luz,3,3,4,10,VIP
1658,55,3,2972.77,Henry Gabriel Abreu,2,1,2,5,Ocasional
1659,81,3,2035.1499999999999,Daniel Mendes,2,1,1,4,Ocasional
1660,70,6,7843.01,Luiz Otávio Costela,2,3,4,9,Regular
1661,23,5,4999.3,Cauê Cunha,3,3,3,9,Regular
1662,100,5,7693.45,Melissa Dias,1,3,4,8,Regular
1663,111,1,47.62,Luiz Gustavo Cavalcanti,1,1,1,3,Inativo
1664,31,9,8070.17,Ana Liz Pereira,3,4,4,11,VIP
1665,62,3,1356.84,Dr. Enrico Carvalho,2,1,1,4,Ocasional
1666,32,4,4143.7699999999995,Enzo Carvalho,3,2,2,7,Regular
1667,88,1,34.71,Dra. Mariana Fonseca,1,1,1,3,Inativo
1668,20,8,5166.32,Lívia Alves,3,4,3,10,VIP
1669,52,3,1434.99,Isabel Barbosa,2,1,1,4,Ocasional
1670,62,3,3381.85,Dr. Arthur Gabriel Moreira,2,1,2,5,Ocasional
1671,85,4,1189.88,Vicente Moura,2,2,1,5,Ocasional
1672,339,2,3528.7200000000003,Otávio Machado,1,1,2,4,Ocasional
1673,157,2,5503.389999999999,Eloah Freitas,1,1,3,5,Ocasional
1674,26,6,7355.1,Davi Luiz Correia,3,3,4,10,VIP
1675,27,4,1843.33,Ayla Araújo,3,2,1,6,Ocasional
1676,36,4,5378.4,Yuri Martins,3,2,3,8,Regular
1677,26,6,7535.04,Luiz Fernando Mendes,3,3,4,10,VIP
1678,50,2,3008.0099999999998,Arthur Gabriel Duarte,2,1,2,5,Ocasional
1679,10,5,1410.1,Matteo Aragão,4,3,1,8,Regular
1680,4,5,1738.52,Pedro Miguel Viana,4,3,1,8,Regular
1681,20,6,10545.27,Hadassa Sousa,3,3,4,10,VIP
1682,58,6,7674.11,Yuri Novaes,2,3,4,9,Regular
1683,67,3,2656.2999999999997,Gabrielly Dias,2,1,2,5,Ocasional
1684,213,4,2436.07,Lavínia da Cruz,1,2,2,5,Ocasional
1685,40,7,11057.44,Fernando Machado,3,4,4,11,VIP
1686,62,2,441.61,Sr. Ravi Lucca Teixeira,2,1,1,4,Ocasional
1687,320,1,2856.77,Stella da Cruz,1,1,2,4,Ocasional
1688,40,3,526.81,Dra. Ana Júlia Novaes,3,1,1,5,Ocasional
1689,16,4,5071.61,Nina Moreira,4,2,3,9,Regular
1690,2,3,4704.17,Yasmin Gonçalves,4,1,3,8,Regular
1691,57,3,1687.27,Anna Liz Oliveira,2,1,1,4,Ocasional
1692,15,5,5816.219999999999,Antônio Vasconcelos,4,3,3,10,VIP
1693,53,4,7757.15,Kamilly Rezende,2,2,4,8,Regular
1694,162,3,4558.51,Gustavo Henrique Rodrigues,1,1,3,5,Ocasional
1695,349,1,620.41,Srta. Bruna Costela,1,1,1,3,Inativo
1696,37,1,608.29,Danilo Pereira,3,1,1,5,Ocasional
1697,84,7,5936.16,Ana Beatriz Machado,2,4,3,9,Regular
1698,91,5,1762.7399999999998,Arthur Miguel da Rocha,1,3,1,5,Ocasional
1699,2,7,12757.630000000001,Liz Vasconcelos,4,4,4,12,VIP
1700,73,2,5249.8,Maria Laura Pires,2,1,3,6,Ocasional
1701,83,2,995.99,Antony Pastor,2,1,1,4,Ocasional
1702,69,4,5164.97,Agatha Cunha,2,2,3,7,Regular
1703,61,4,4920.3099999999995,Gabriel Lima,2,2,3,7,Regular
1704,228,3,2737.4,Breno Souza,1,1,2,4,Ocasional
1705,56,3,5740.860000000001,Rhavi da Conceição,2,1,3,6,Ocasional
1706,18,4,12353.89,Pedro Lima,4,2,4,10,VIP
1707,264,2,1918.46,Luigi Dias,1,1,1,3,Inativo
1708,19,4,2998.0099999999998,Maria Cecília Guerra,4,2,2,8,Regular
1709,141,5,2418.73,Léo Macedo,1,3,2,6,Ocasional
1710,70,6,5331.2300000000005,José Martins,2,3,3,8,Regular
1711,7,6,11306.74,Camila Andrade,4,3,4,11,VIP
1712,62,3,2967.0699999999997,Samuel Castro,2,1,2,5,Ocasional
1713,173,4,4503.92,Maria Clara Machado,1,2,3,6,Ocasional
1714,14,7,6025.68,Gael Henrique Moraes,4,4,3,11,VIP
1715,171,1,1296.8,Sr. Benicio da Paz,1,1,1,3,Inativo
1716,38,3,2975.8,Apollo Almeida,3,1,2,6,Ocasional
1717,25,2,863.02,Theo Alves,3,1,1,5,Ocasional
1718,49,4,7786.99,Jade Lopes,2,2,4,8,Regular
1719,17,11,17718.08,Renan Almeida,4,4,4,12,VIP
1720,48,1,121.31,Amanda Sá,2,1,1,4,Ocasional
1721,36,3,1593.37,Arthur Miguel Almeida,3,1,1,5,Ocasional
1722,167,2,1994.4499999999998,Srta. Luiza Viana,1,1,1,3,Inativo
1723,47,6,3221.07,Sara Gonçalves,2,3,2,7,Regular
1724,6,6,2657.63,Bárbara Leão,4,3,2,9,Regular
1725,55,7,9425.34,Henrique Mendonça,2,4,4,10,VIP
1726,199,1,5161.86,Dr. Fernando Costela,1,1,3,5,Ocasional
1727,122,4,5480.1,Pedro Ribeiro,1,2,3,6,Ocasional
1728,33,4,4667.75,Eloá Caldeira,3,2,3,8,Regular
1729,3,4,11400.26,Calebe Nogueira,4,2,4,10,VIP
1730,40,5,2813.67,Vitor Gabriel Montenegro,3,3,2,8,Regular
1731,50,2,1443.66,Rael Fogaça,2,1,1,4,Ocasional
1732,216,3,6496.75,José Pedro Nogueira,1,1,3,5,Ocasional
1733,120,2,700.38,Mateus Nunes,1,1,1,3,Inativo
1734,160,2,948.6,Júlia Vieira,1,1,1,3,Inativo
1735,82,8,7917.01,Pietra Rios,2,4,4,10,VIP
1736,91,3,3126.3199999999997,Otávio Camargo,1,1,2,4,Ocasional
1737,14,6,5776.04,Dra. Heloisa Farias,4,3,3,10,VIP
1738,21,6,2521.18,Mariah Sampaio,3,3,2,8,Regular
1739,38,5,3122.22,Luana Cassiano,3,3,2,8,Regular
1740,44,3,1922.6100000000001,Sr. Nicolas da Mota,2,1,1,4,Ocasional
1741,26,3,2056.31,Dra. Heloísa Pimenta,3,1,1,5,Ocasional
1742,6,5,5293.87,Ana Lívia Lima,4,3,3,10,VIP
1743,65,5,2076.44,Srta. Maria Alice Ribeiro,2,3,1,6,Ocasional
1744,61,5,7592.46,Agatha Fernandes,2,3,4,9,Regular
1745,42,5,14409.960000000001,Srta. Eloah Fonseca,3,3,4,10,VIP
1746,265,1,544.25,Ana Beatriz Correia,1,1,1,3,Inativo
1747,47,4,3662.08,Srta. Stella Cardoso,2,2,2,6,Ocasional
1748,6,2,7103.570000000001,Srta. Maria Liz Martins,4,1,3,8,Regular
1749,27,1,50.84,Henry Gabriel Duarte,3,1,1,5,Ocasional
1750,25,8,15588.23,Isadora Sampaio,3,4,4,11,VIP
1751,115,4,3470.75,Srta. Lunna Fernandes,1,2,2,5,Ocasional
1752,274,2,1250.42,Rhavi Fonseca,1,1,1,3,Inativo
1753,24,7,10490.67,Ana Liz da Conceição,3,4,4,11,VIP
1754,94,5,3197.94,Théo Pacheco,1,3,2,6,Ocasional
1755,143,1,1050.96,Liz Carvalho,1,1,1,3,Inativo
1756,3,6,1442.26,Kamilly Viana,4,3,1,8,Regular
1757,61,4,3266.1,Anthony Gabriel Vieira,2,2,2,6,Ocasional
1758,147,2,1642.62,Liam Câmara,1,1,1,3,Inativo
1759,7,6,3017.54,Maria Helena Viana,4,3,2,9,Regular
1760,4,2,8087.21,Lívia Pereira,4,1,4,9,Regular
1761,186,3,1105.06,Fernando Teixeira,1,1,1,3,Inativo
1762,28,5,13115.5,Ana Lívia Gomes,3,3,4,10,VIP
1763,71,5,3848.1000000000004,Isis Nascimento,2,3,2,7,Regular
1764,312,1,1869.55,Rafaela Silva,1,1,1,3,Inativo
1765,3,7,6852.92,Dr. Anthony Gabriel da Mata,4,4,3,11,VIP
1766,148,7,12601.15,Enzo Aragão,1,4,4,9,Regular
1767,13,6,3640.5099999999998,Maria Isis Sá,4,3,2,9,Regular
1768,59,3,984.6899999999999,Leonardo Cardoso,2,1,1,4,Ocasional
1769,25,7,5475.44,Benicio Andrade,3,4,3,10,VIP
1770,9,5,12497.220000000001,Breno Camargo,4,3,4,11,VIP
1771,35,7,4892.73,Dra. Rebeca Rodrigues,3,4,3,10,VIP
1772,69,3,6975.77,Eloah Mendonça,2,1,3,6,Ocasional
1773,74,2,3272.42,Maria Silva,2,1,2,5,Ocasional
1774,65,8,9070.04,Asafe da Cunha,2,4,4,10,VIP
1775,181,2,1034.12,João Felipe Pinto,1,1,1,3,Inativo
1776,90,4,1335.5,Srta. Sophie Azevedo,1,2,1,4,Ocasional
1777,5,4,3837.1800000000003,João Lucas da Cunha,4,2,2,8,Regular
1778,47,3,1168.42,Sr. Renan Pereira,2,1,1,4,Ocasional
1779,118,5,8475.58,Dra. Luna da Costa,1,3,4,8,Regular
1780,247,1,954.98,Mariana Pastor,1,1,1,3,Inativo
1781,25,4,8000.69,João Guilherme Machado,3,2,4,9,Regular
1782,46,5,5665.15,Maria Helena Santos,2,3,3,8,Regular
1783,233,3,1167.8200000000002,Isaac Nunes,1,1,1,3,Inativo
1784,88,6,9500.220000000001,Giovanna Cavalcanti,1,3,4,8,Regular
1786,93,5,6342.25,Thomas Pires,1,3,3,7,Regular
1787,21,6,8793.79,Marcelo Gomes,3,3,4,10,VIP
1788,36,4,3847.6499999999996,Isabelly Ramos,3,2,2,7,Regular
1789,48,4,2167.81,Cecilia Correia,2,2,1,5,Ocasional
1790,25,11,9784.84,Raul Sá,3,4,4,11,VIP
1791,12,6,5717.75,Lucas Almeida,4,3,3,10,VIP
1792,253,1,839.31,Maria Júlia Freitas,1,1,1,3,Inativo
1793,21,4,6457.280000000001,Juliana Vargas,3,2,3,8,Regular
1795,97,3,6329.349999999999,Mathias Pereira,1,1,3,5,Ocasional
1796,206,3,929.8,Bárbara Melo,1,1,1,3,Inativo
1797,247,2,1729.77,Luiz Miguel Marques,1,1,1,3,Inativo
1798,13,4,7923.07,Caio Cardoso,4,2,4,10,VIP
1799,259,1,576.18,Mateus Albuquerque,1,1,1,3,Inativo
1800,163,3,5062.18,Dr. Dante Marques,1,1,3,5,Ocasional
1801,26,5,8259.02,Matheus Pereira,3,3,4,10,VIP
1802,56,7,8562.98,Maria Luiza Carvalho,2,4,4,10,VIP
1803,31,4,3427.8,Ana Vitória Machado,3,2,2,7,Regular
1804,27,5,3514.2200000000003,Dr. Marcelo Mendonça,3,3,2,8,Regular
1805,99,6,4392.61,Dr. Alexandre Santos,1,3,3,7,Regular
1806,50,5,8118.32,Raul Cavalcante,2,3,4,9,Regular
1807,27,10,10306.07,Lunna Silveira,3,4,4,11,VIP
1808,55,1,1012.62,Isabella Borges,2,1,1,4,Ocasional
1809,44,2,10187.09,Sr. Caleb Camargo,2,1,4,7,Regular
1810,18,6,13250.18,Anna Liz Souza,4,3,4,11,VIP
1811,358,1,87.78,Ravi Barbosa,1,1,1,3,Inativo
1812,58,2,1163.39,Dra. Aurora Montenegro,2,1,1,4,Ocasional
1813,25,3,5273.86,Hadassa Jesus,3,1,3,7,Regular
1814,108,5,7704.63,Théo Casa Grande,1,3,4,8,Regular
1815,47,3,1490.05,Arthur Miguel da Luz,2,1,1,4,Ocasional
1816,32,8,6209.71,Heitor Viana,3,4,3,10,VIP
1817,13,8,3269.3199999999997,Yago Lopes,4,4,2,10,VIP
1818,50,3,13985.529999999999,Sra. Letícia Nogueira,2,1,4,7,Regular
1819,26,6,8260.97,Nathan Carvalho,3,3,4,10,VIP
1820,47,3,6520.55,Dr. Lucas Gabriel Fogaça,2,1,3,6,Ocasional
1821,39,1,420.12,Arthur Gabriel Nogueira,3,1,1,5,Ocasional
1822,15,5,6073.599999999999,Igor Brito,4,3,3,10,VIP
1823,12,5,1772.53,Pedro Miguel Rodrigues,4,3,1,8,Regular
1824,36,2,3231.36,Dra. Maria Eduarda da Conceição,3,1,2,6,Ocasional
1825,16,3,828.1199999999999,Dr. Bento Albuquerque,4,1,1,6,Ocasional
1826,43,2,7015.77,Fernando Ferreira,3,1,3,7,Regular
1827,61,4,1069.7,Esther Cardoso,2,2,1,5,Ocasional
1828,33,5,5856.73,Igor Rios,3,3,3,9,Regular
1829,94,2,2379.46,Gustavo Sales,1,1,2,4,Ocasional
1830,40,2,6055.3099999999995,Larissa Azevedo,3,1,3,7,Regular
1831,37,5,10192.17,Emanuella Nogueira,3,3,4,10,VIP
1832,291,4,11586.02,Bento Jesus,1,2,4,7,Regular
1833,161,1,640.99,Ana Liz Barbosa,1,1,1,3,Inativo
1834,4,5,10335.18,Dra. Carolina Silva,4,3,4,11,VIP
1835,207,3,4741.08,Rebeca Marques,1,1,3,5,Ocasional
1836,32,5,3919.29,Brayan Monteiro,3,3,2,8,Regular
1837,134,2,1942.1999999999998,Zoe da Cunha,1,1,1,3,Inativo
1838,55,3,3119.76,Sr. Bernardo Albuquerque,2,1,2,5,Ocasional
1839,55,5,1932.6799999999998,Ágatha Novais,2,3,1,6,Ocasional
1840,151,1,308.86,Melina Câmara,1,1,1,3,Inativo
1841,5,4,4395.18,Ísis Machado,4,2,3,9,Regular
1842,49,4,10925.630000000001,Otto Rios,2,2,4,8,Regular
1843,29,2,6297.47,Ravi Martins,3,1,3,7,Regular
1844,69,7,12856.66,Henry Gabriel Silva,2,4,4,10,VIP
1845,47,3,3661.13,Dra. Eloá Azevedo,2,1,2,5,Ocasional
1846,40,3,2828.24,Pedro Henrique Caldeira,3,1,2,6,Ocasional
1847,3,4,4721.41,Luara Nunes,4,2,3,9,Regular
1848,153,3,470.01000000000005,Srta. Maitê da Costa,1,1,1,3,Inativo
1849,63,4,8037.33,Daniela Moraes,2,2,4,8,Regular
1850,67,5,11492.91,Cecilia Cavalcante,2,3,4,9,Regular
1851,50,6,11285.37,Carolina Pires,2,3,4,9,Regular
1852,266,2,3071.29,Lara Rezende,1,1,2,4,Ocasional
1853,56,6,2327.9500000000003,Sr. Anthony Rocha,2,3,2,7,Regular
1854,58,4,6768.01,Srta. Hellena Cardoso,2,2,3,7,Regular
1855,15,7,14141.92,Srta. Ana Cecília Vasconcelos,4,4,4,12,VIP
1856,33,4,10255.73,Benjamin Ferreira,3,2,4,9,Regular
1857,69,4,10228.33,Davi Lucca Vargas,2,2,4,8,Regular
1858,81,5,5921.709999999999,Ana Sophia Melo,2,3,3,8,Regular
1859,2,2,339.53,Vitor Hugo da Mota,4,1,1,6,Ocasional
1860,15,7,9090.12,Dante Leão,4,4,4,12,VIP
1861,24,5,3815.12,Maria Júlia Marques,3,3,2,8,Regular
1862,3,6,7324.36,Maria Cecília Fonseca,4,3,4,11,VIP
1863,23,8,6600.719999999999,Fernanda Rodrigues,3,4,3,10,VIP
1864,126,3,8026.39,Rafael Correia,1,1,4,6,Ocasional
1865,43,5,5788.0,Henrique Viana,3,3,3,9,Regular
1866,16,4,2445.0099999999998,Clarice Brito,4,2,2,8,Regular
1867,2,10,24444.489999999998,Isaque Silveira,4,4,4,12,VIP
1868,8,4,5620.09,Davi Luiz Silveira,4,2,3,9,Regular
1869,23,4,6723.639999999999,José Pedro Costa,3,2,3,8,Regular
1871,27,6,5529.78,Dra. Juliana Monteiro,3,3,3,9,Regular
1872,146,2,3212.41,Pedro Henrique Freitas,1,1,2,4,Ocasional
1873,26,3,2029.67,Bruno Cavalcanti,3,1,1,5,Ocasional
1874,33,6,4649.13,Lorena Moraes,3,3,3,9,Regular
1875,6,7,5669.59,Maria Helena Gonçalves,4,4,3,11,VIP
1876,204,4,2344.14,Sr. João Felipe Cirino,1,2,2,5,Ocasional
1877,3,5,5903.23,Oliver Camargo,4,3,3,10,VIP
1878,53,3,2722.85,Natália Câmara,2,1,2,5,Ocasional
1879,251,3,4460.51,Diego Campos,1,1,3,5,Ocasional
1880,22,5,13083.8,Luiz Miguel Ribeiro,3,3,4,10,VIP
1881,21,4,1738.51,Enrico Ramos,3,2,1,6,Ocasional
1883,152,5,7650.36,Bento Ramos,1,3,4,8,Regular
1884,7,7,8517.28,Dr. Valentim Ribeiro,4,4,4,12,VIP
1885,44,3,4086.5699999999997,Francisco Dias,2,1,2,5,Ocasional
1887,73,6,3941.08,Davi Costa,2,3,2,7,Regular
1888,344,1,3474.91,Srta. Ester Oliveira,1,1,2,4,Ocasional
1889,22,9,7120.91,Sr. Isaac Casa Grande,3,4,3,10,VIP
1890,30,4,2576.9,Emanuella Abreu,3,2,2,7,Regular
1891,29,6,6004.860000000001,Thiago Ferreira,3,3,3,9,Regular
1892,58,4,7261.84,Mathias Pereira,2,2,3,7,Regular
1893,34,2,376.43,Samuel Campos,3,1,1,5,Ocasional
1894,206,3,4632.87,Caio Monteiro,1,1,3,5,Ocasional
1895,11,3,3854.09,Julia Cardoso,4,1,2,7,Regular
1896,36,5,3279.03,Allana Porto,3,3,2,8,Regular
1897,72,3,671.63,Dra. Daniela Silva,2,1,1,4,Ocasional
1898,27,8,5532.88,Maitê Cunha,3,4,3,10,VIP
1899,50,5,3536.29,João Gabriel Gonçalves,2,3,2,7,Regular
1900,11,7,2857.11,Lorena Vargas,4,4,2,10,VIP
1901,89,6,6951.75,Emanuella Guerra,1,3,3,7,Regular
1902,364,1,299.57,Maria Clara Gomes,1,1,1,3,Inativo
1903,5,5,3865.69,Erick Pires,4,3,2,9,Regular
1904,295,1,514.28,Manuela Farias,1,1,1,3,Inativo
1905,16,5,5433.610000000001,Lorenzo Machado,4,3,3,10,VIP
1906,2,6,4753.7699999999995,Antony da Cunha,4,3,3,10,VIP
1907,1,5,5237.2,Aylla Carvalho,4,3,3,10,VIP
1908,45,2,1020.26,Maria Luiza Martins,2,1,1,4,Ocasional
1909,101,4,2395.14,Isabel Barros,1,2,2,5,Ocasional
1910,28,6,6241.93,Dra. Vitória Nascimento,3,3,3,9,Regular
1911,29,3,1754.9,Dra. Luana Costa,3,1,1,5,Ocasional
1912,12,3,3064.83,Lívia Cirino,4,1,2,7,Regular
1913,51,7,9214.65,Luiz Fernando Mendonça,2,4,4,10,VIP
1914,171,4,5065.9800000000005,Davi Miguel Leão,1,2,3,6,Ocasional
1915,120,3,1710.46,Milena das Neves,1,1,1,3,Inativo
1916,17,6,11818.24,Antônio Jesus,4,3,4,11,VIP
1917,71,4,4423.860000000001,Sra. Júlia Nunes,2,2,3,7,Regular
1918,2,7,9843.039999999999,Sr. Mateus Câmara,4,4,4,12,VIP
1919,25,5,2264.2200000000003,Enrico Moura,3,3,1,7,Regular
1920,42,8,7629.639999999999,Levi Pimenta,3,4,4,11,VIP
1921,25,8,7134.58,Maya da Cruz,3,4,3,10,VIP
1922,129,3,1481.51,Leandro Pimenta,1,1,1,3,Inativo
1923,3,5,4297.34,Larissa Câmara,4,3,2,9,Regular
1924,24,4,3250.87,Dr. Davi Lucas Pereira,3,2,2,7,Regular
1925,33,3,7518.7,Pietro Cardoso,3,1,4,8,Regular
1926,10,8,7549.2,Marcela Correia,4,4,4,12,VIP
1927,11,7,2305.6,Asafe da Rosa,4,4,2,10,VIP
1928,55,5,4266.26,Arthur Casa Grande,2,3,2,7,Regular
1929,133,6,3794.6,Maria Júlia Correia,1,3,2,6,Ocasional
1930,14,4,5494.860000000001,José Pedro Santos,4,2,3,9,Regular
1931,38,5,3764.93,Vitor Hugo Novaes,3,3,2,8,Regular
1932,43,6,4946.04,Srta. Ana Beatriz da Cruz,3,3,3,9,Regular
1933,67,2,904.27,Antony da Rosa,2,1,1,4,Ocasional
1934,78,3,895.23,Arthur Gabriel Novaes,2,1,1,4,Ocasional
1935,64,7,5204.41,Raquel Macedo,2,4,3,9,Regular
1936,87,2,2083.7,Eduardo da Conceição,2,1,1,4,Ocasional
1937,169,2,435.60999999999996,Sr. Gael Henrique Costa,1,1,1,3,Inativo
1938,24,3,5620.72,Dr. Cauê Cunha,3,1,3,7,Regular
1939,43,6,17076.27,Ana Lívia Siqueira,3,3,4,10,VIP
1940,21,4,3203.9,Manuella Sá,3,2,2,7,Regular
1941,232,1,541.5,Igor Sousa,1,1,1,3,Inativo
1942,79,5,7853.0199999999995,Augusto Cardoso,2,3,4,9,Regular
1943,16,5,2639.64,Davi Lucca da Rocha,4,3,2,9,Regular
1944,52,2,4229.82,Renan Ramos,2,1,2,5,Ocasional
1945,3,9,13917.68,João Aragão,4,4,4,12,VIP
1946,47,4,2716.72,Olivia Pires,2,2,2,6,Ocasional
1947,131,2,1770.29,Manuela Gomes,1,1,1,3,Inativo
1948,118,4,2695.22,Esther Machado,1,2,2,5,Ocasional
1949,12,3,2085.59,Vinícius Marques,4,1,1,6,Ocasional
1950,113,2,2527.01,Rafael Aragão,1,1,2,4,Ocasional
1951,51,5,6618.740000000001,Isis Sales,2,3,3,8,Regular
1952,106,2,4347.35,Thales Gomes,1,1,2,4,Ocasional
1953,185,2,402.58,Dom Casa Grande,1,1,1,3,Inativo
1954,6,9,17875.07,Evelyn Correia,4,4,4,12,VIP
1955,253,2,4756.8,Leandro Montenegro,1,1,3,5,Ocasional
1956,284,1,300.26,Anthony Freitas,1,1,1,3,Inativo
1957,194,2,2045.8,Sara da Cunha,1,1,1,3,Inativo
1958,233,2,4839.61,Isabel da Mata,1,1,3,5,Ocasional
1959,49,3,2019.39,Daniela Almeida,2,1,1,4,Ocasional
1960,100,3,730.84,Léo Oliveira,1,1,1,3,Inativo
1961,55,5,11322.68,Helena Aparecida,2,3,4,9,Regular
1962,126,3,534.24,Srta. Maria Luísa Cavalcanti,1,1,1,3,Inativo
1963,63,3,7693.09,Amanda Ramos,2,1,4,7,Regular
1964,67,1,2791.28,Augusto da Mata,2,1,2,5,Ocasional
1965,3,5,12931.34,Breno Freitas,4,3,4,11,VIP
1966,9,7,13251.26,Maria Liz da Rosa,4,4,4,12,VIP
1967,249,2,2246.7000000000003,Leandro Sá,1,1,1,3,Inativo
1968,18,2,3200.81,Melina Porto,4,1,2,7,Regular
1969,17,5,4187.73,Luana Vasconcelos,4,3,2,9,Regular
1970,162,8,5117.76,Diego Silva,1,4,3,8,Regular
1971,7,8,6696.21,Augusto da Paz,4,4,3,11,VIP
1972,52,5,11065.81,Brenda Borges,2,3,4,9,Regular
1973,61,6,7369.18,Enrico Moraes,2,3,4,9,Regular
1974,57,2,896.0,Maria Luísa Almeida,2,1,1,4,Ocasional
1975,76,6,5231.0199999999995,Maria Laura Correia,2,3,3,8,Regular
1976,150,2,629.01,Vinícius da Costa,1,1,1,3,Inativo
1977,68,3,5783.120000000001,Ana Liz Araújo,2,1,3,6,Ocasional
1978,17,5,9001.69,Ian Cavalcanti,4,3,4,11,VIP
1979,57,4,8273.68,Srta. Sofia Fernandes,2,2,4,8,Regular
1980,240,1,1548.42,Lorena Vasconcelos,1,1,1,3,Inativo
1981,14,4,2520.47,Henry Gabriel Silva,4,2,2,8,Regular
1982,19,2,1937.96,Ana Luiza Moura,4,1,1,6,Ocasional
1983,6,6,8980.800000000001,Augusto Lima,4,3,4,11,VIP
1984,10,4,3608.64,Davi Lucas Martins,4,2,2,8,Regular
1985,116,3,5597.18,Isadora Nogueira,1,1,3,5,Ocasional
1986,10,6,4011.6800000000003,Sra. Maria Flor Freitas,4,3,2,9,Regular
1987,9,6,8351.06,Leandro Pimenta,4,3,4,11,VIP
1988,120,3,6730.889999999999,Letícia Carvalho,1,1,3,5,Ocasional
1989,332,1,618.44,Liz Azevedo,1,1,1,3,Inativo
1990,46,5,3219.6800000000003,Natália das Neves,2,3,2,7,Regular
1991,38,2,4460.59,Thiago da Rosa,3,1,3,7,Regular
1992,52,6,3674.83,Zoe Nascimento,2,3,2,7,Regular
1993,34,7,7346.03,Eloah Ribeiro,3,4,4,11,VIP
1994,5,3,1929.3,Ana Cecília Gonçalves,4,1,1,6,Ocasional
1995,20,2,3700.37,Vitor da Cunha,3,1,2,6,Ocasional
1996,13,4,4064.71,Lorena Rios,4,2,2,8,Regular
1997,23,2,3004.4900000000002,Anthony Gabriel Cassiano,3,1,2,6,Ocasional
1998,165,2,877.25,Dr. Nathan Caldeira,1,1,1,3,Inativo
1999,3,4,7440.91,Pedro Lucas Nogueira,4,2,4,10,VIP
2000,19,5,5737.93,Elisa Leão,4,3,3,10,VIP
2001,21,6,1772.0400000000002,Benicio da Conceição,3,3,1,7,Regular
2002,18,9,5767.88,Dr. Murilo Freitas,4,4,3,11,VIP
2003,7,6,2777.04,Dr. Pedro Henrique Mendes,4,3,2,9,Regular
2004,2,5,8697.0,Sr. Henrique Porto,4,3,4,11,VIP
2005,33,3,5085.84,Lunna Freitas,3,1,3,7,Regular
2006,46,6,8002.4,Samuel Barros,2,3,4,9,Regular
2007,80,4,4514.04,Ana Laura Abreu,2,2,3,7,Regular
2008,273,3,2424.14,Isabela Vasconcelos,1,1,2,4,Ocasional
2009,120,3,741.3699999999999,Srta. Manuella Novais,1,1,1,3,Inativo
2010,91,4,3929.0299999999997,Manuella Carvalho,1,2,2,5,Ocasional
2011,53,2,6639.0,Benjamin Fernandes,2,1,3,6,Ocasional
2012,185,1,311.24,João Felipe Melo,1,1,1,3,Inativo
2013,169,6,7084.45,Laís Camargo,1,3,3,7,Regular
2014,18,7,5091.75,Gustavo Andrade,4,4,3,11,VIP
2015,19,5,2369.66,Otto Barros,4,3,2,9,Regular
2016,37,5,3258.09,Yasmin Cavalcanti,3,3,2,8,Regular
2017,28,7,7093.48,Ester Dias,3,4,3,10,VIP
2018,56,3,11824.58,Hadassa Duarte,2,1,4,7,Regular
2019,47,6,5769.16,Luiz Henrique Lima,2,3,3,8,Regular
2020,107,3,2624.88,Sra. Elisa Pastor,1,1,2,4,Ocasional
2021,9,5,2334.08,Jade Garcia,4,3,2,9,Regular
2022,50,5,1396.9699999999998,Manuela Mendes,2,3,1,6,Ocasional
2023,80,8,4782.68,Maria Luísa Ribeiro,2,4,3,9,Regular
2024,73,4,5959.3099999999995,Natália Pacheco,2,2,3,7,Regular
2025,118,3,5733.490000000001,Carolina Moreira,1,1,3,5,Ocasional
2026,116,4,2064.6800000000003,Zoe Pereira,1,2,1,4,Ocasional
2027,15,5,17608.170000000002,Anna Liz Martins,4,3,4,11,VIP
2028,38,2,2386.76,Otávio Monteiro,3,1,2,6,Ocasional
2029,327,1,515.62,Ana Costela,1,1,1,3,Inativo
2030,21,8,12555.61,João Guilherme Fernandes,3,4,4,11,VIP
2031,205,2,657.69,Otávio Lima,1,1,1,3,Inativo
2032,27,4,8208.45,Dra. Zoe Sá,3,2,4,9,Regular
2033,16,3,6267.55,Davi Lucas Rocha,4,1,3,8,Regular
2034,74,5,8080.55,Anna Liz Albuquerque,2,3,4,9,Regular
2035,25,3,2904.2699999999995,Sr. Joaquim Silveira,3,1,2,6,Ocasional
2036,70,3,1237.35,João Miguel Duarte,2,1,1,4,Ocasional
2037,42,3,4089.74,Dra. Sara Costela,3,1,2,6,Ocasional
2038,116,3,6534.200000000001,Dra. Maria Liz Nunes,1,1,3,5,Ocasional
2039,80,2,1150.33,Luna Sá,2,1,1,4,Ocasional
2040,136,2,458.27,Maria Flor da Costa,1,1,1,3,Inativo
2041,59,5,6126.28,Matteo Rocha,2,3,3,8,Regular
2042,5,4,4061.69,Emanuel Nogueira,4,2,2,8,Regular
2043,73,3,1718.83,Antonella Garcia,2,1,1,4,Ocasional
2044,209,2,1926.3000000000002,Luna Porto,1,1,1,3,Inativo
2045,59,5,7768.29,Arthur Miguel Correia,2,3,4,9,Regular
2046,4,1,182.82,Otávio Carvalho,4,1,1,6,Ocasional
2047,140,2,3358.5699999999997,Liam Vieira,1,1,2,4,Ocasional
2048,1,6,16354.7,Dra. Agatha Nunes,4,3,4,11,VIP
2049,6,2,720.3199999999999,Dr. Daniel Santos,4,1,1,6,Ocasional
2050,20,5,3203.0299999999997,Antônio Ramos,3,3,2,8,Regular
2051,38,7,5980.93,Arthur Gabriel Costa,3,4,3,10,VIP
2052,203,2,4564.48,Melina Rezende,1,1,3,5,Ocasional
2053,35,4,7053.18,Calebe da Conceição,3,2,3,8,Regular
2054,6,2,1858.48,Mariah Almeida,4,1,1,6,Ocasional
2055,10,9,11839.31,João Azevedo,4,4,4,12,VIP
2056,89,3,2409.24,Catarina Abreu,1,1,2,4,Ocasional
2057,4,12,7566.2,Henrique Castro,4,4,4,12,VIP
2058,6,6,14731.689999999999,Luana Brito,4,3,4,11,VIP
2059,14,6,3686.75,Clarice Souza,4,3,2,9,Regular
2060,66,7,8210.82,Letícia Vieira,2,4,4,10,VIP
2061,12,3,3126.8099999999995,Vitor Pinto,4,1,2,7,Regular
2062,239,3,1047.68,Benicio Melo,1,1,1,3,Inativo
2064,3,6,2726.84,Ísis Pacheco,4,3,2,9,Regular
2065,17,5,12263.060000000001,Isabelly Carvalho,4,3,4,11,VIP
2066,113,7,12546.310000000001,Milena Cavalcante,1,4,4,9,Regular
2067,5,5,6892.89,Mathias Monteiro,4,3,3,10,VIP
2068,58,4,1793.73,Thales Camargo,2,2,1,5,Ocasional
2069,174,4,1950.77,Ana Júlia Casa Grande,1,2,1,4,Ocasional
2070,9,6,4250.3,Alice Casa Grande,4,3,2,9,Regular
2071,7,4,2381.5600000000004,Allana Pacheco,4,2,2,8,Regular
2072,40,7,10876.92,Maria Dias,3,4,4,11,VIP
2073,154,1,361.24,Dra. Amanda Rocha,1,1,1,3,Inativo
2074,29,3,1363.99,Davi Lucca Caldeira,3,1,1,5,Ocasional
2075,170,2,919.72,Laura Siqueira,1,1,1,3,Inativo
2076,69,3,2594.66,Ravi Garcia,2,1,2,5,Ocasional
2077,180,1,101.38,Srta. Maysa Ribeiro,1,1,1,3,Inativo
2078,56,5,9152.4,Caroline Barros,2,3,4,9,Regular
2079,18,8,5995.1,Matteo Pereira,4,4,3,11,VIP
2080,47,4,3210.33,Júlia Machado,2,2,2,6,Ocasional
2081,76,2,2282.0699999999997,Pedro Cirino,2,1,2,5,Ocasional
2082,5,6,11097.72,Clara Albuquerque,4,3,4,11,VIP
2083,29,3,9036.25,Maria Flor da Cruz,3,1,4,8,Regular
2084,25,5,8833.54,Ayla Campos,3,3,4,10,VIP
2085,51,4,1066.07,Clarice da Costa,2,2,1,5,Ocasional
2086,10,2,3467.21,Vitor Hugo Vieira,4,1,2,7,Regular
2087,235,3,4378.64,Antônio Peixoto,1,1,3,5,Ocasional
2088,6,5,1654.3400000000001,Antonella Brito,4,3,1,8,Regular
2089,25,6,11442.35,Luana Cassiano,3,3,4,10,VIP
2090,24,7,13943.689999999999,João Lucas Jesus,3,4,4,11,VIP
2091,92,2,1790.59,Sra. Maria Luiza Lopes,1,1,1,3,Inativo
2092,244,3,5384.79,Allana Carvalho,1,1,3,5,Ocasional
2093,53,3,3573.82,Laura Abreu,2,1,2,5,Ocasional
2095,21,8,12345.630000000001,Caio Castro,3,4,4,11,VIP
2096,26,3,1311.37,Felipe Viana,3,1,1,5,Ocasional
2097,129,2,648.6800000000001,Henry Araújo,1,1,1,3,Inativo
2098,21,5,4548.52,Raul Borges,3,3,3,9,Regular
2099,82,4,6881.68,Mariane Azevedo,2,2,3,7,Regular
2100,67,3,3517.5299999999997,Maya Sá,2,1,2,5,Ocasional
2101,113,4,4587.74,Pedro Lucas Leão,1,2,3,6,Ocasional
2102,46,7,10748.119999999999,Luiz Otávio Monteiro,2,4,4,10,VIP
2103,68,3,2741.48,Samuel Jesus,2,1,2,5,Ocasional
2104,161,4,4249.88,Milena Abreu,1,2,2,5,Ocasional
2105,7,3,2689.64,Breno Pinto,4,1,2,7,Regular
2106,23,4,5090.360000000001,Emanuel Pacheco,3,2,3,8,Regular
2107,3,4,6689.48,Thomas da Rosa,4,2,3,9,Regular
2108,119,2,1159.4,Benjamim das Neves,1,1,1,3,Inativo
2109,2,5,10588.42,Marina da Cunha,4,3,4,11,VIP
2110,81,6,7563.400000000001,João Miguel Ramos,2,3,4,9,Regular
2111,195,2,1024.45,Clara Martins,1,1,1,3,Inativo
2112,42,4,9848.85,Laura Montenegro,3,2,4,9,Regular
2113,1,4,4168.08,Maria Luiza da Luz,4,2,2,8,Regular
2114,8,5,5686.75,Dr. Gael Henrique Ribeiro,4,3,3,10,VIP
2115,43,6,7793.849999999999,Vitória Lima,3,3,4,10,VIP
2116,89,2,4831.03,Maria Isis Aragão,1,1,3,5,Ocasional
2117,25,4,962.4300000000001,Ana Julia Barros,3,2,1,6,Ocasional
2118,89,3,4228.26,Cauê Sá,1,1,2,4,Ocasional
2119,5,6,10926.73,Srta. Maria Julia Cassiano,4,3,4,11,VIP
2120,90,4,5452.88,Sr. Dante Barbosa,1,2,3,6,Ocasional
2121,4,3,5475.52,Eloah Novais,4,1,3,8,Regular
2122,47,4,2818.8999999999996,Ian Martins,2,2,2,6,Ocasional
2123,138,3,3790.25,Olivia Cassiano,1,1,2,4,Ocasional
2124,130,4,10418.87,Fernanda Mendonça,1,2,4,7,Regular
2125,115,4,2188.37,Alice Rocha,1,2,1,4,Ocasional
2126,2,10,13170.050000000001,Gael Vargas,4,4,4,12,VIP
2127,44,8,18195.21,Maria Helena Novaes,2,4,4,10,VIP
2128,19,4,2304.86,Maria Alice Azevedo,4,2,2,8,Regular
2129,7,4,4723.91,Caio Duarte,4,2,3,9,Regular
2130,11,4,2368.07,Henrique Costa,4,2,2,8,Regular
2131,42,6,5383.79,Davi Miguel da Paz,3,3,3,9,Regular
2132,76,4,1912.9699999999998,Ana Vitória Albuquerque,2,2,1,5,Ocasional
2133,94,6,2503.0699999999997,Dra. Maria Julia Sampaio,1,3,2,6,Ocasional
2134,38,5,4622.15,Luan Almeida,3,3,3,9,Regular
2135,49,5,3695.26,Mariana Campos,2,3,2,7,Regular
2136,56,3,2391.11,Pietro Monteiro,2,1,2,5,Ocasional
2137,12,5,6679.96,Dr. José Pedro Cassiano,4,3,3,10,VIP
2138,53,5,11885.37,Juan Viana,2,3,4,9,Regular
2139,54,5,1892.9,Bella Alves,2,3,1,6,Ocasional
2140,30,2,10773.94,Rafaela Nascimento,3,1,4,8,Regular
2141,177,5,13334.14,Ian Moura,1,3,4,8,Regular
2142,109,3,3610.47,Sra. Emilly Gomes,1,1,2,4,Ocasional
2143,97,2,1370.8,Rael Cirino,1,1,1,3,Inativo
2144,9,6,5683.92,Gabrielly Casa Grande,4,3,3,10,VIP
2145,117,3,2668.68,Srta. Maria Alice Pereira,1,1,2,4,Ocasional
2146,181,3,2566.2,Srta. Julia Moreira,1,1,2,4,Ocasional
2147,19,7,11928.63,Sr. José Pedro Abreu,4,4,4,12,VIP
2148,11,6,5034.47,Dr. Paulo da Cunha,4,3,3,10,VIP
2149,32,4,4139.16,Nicole Monteiro,3,2,2,7,Regular
2150,122,4,3082.6,Vinicius da Luz,1,2,2,5,Ocasional
2151,174,4,2635.52,Bento Santos,1,2,2,5,Ocasional
2152,15,6,5915.0599999999995,Maria Eduarda Rezende,4,3,3,10,VIP
2153,93,3,3271.47,Emanuel Pimenta,1,1,2,4,Ocasional
2154,163,3,5508.41,Cauã Lima,1,1,3,5,Ocasional
2155,103,4,3125.0899999999997,Alice Brito,1,2,2,5,Ocasional
2156,56,4,6619.7,Rael Martins,2,2,3,7,Regular
2157,35,8,10019.06,Sr. Arthur Gabriel da Rocha,3,4,4,11,VIP
2158,3,3,957.8199999999999,Daniel Macedo,4,1,1,6,Ocasional
2159,224,4,5640.58,Ana Beatriz Sousa,1,2,3,6,Ocasional
2160,19,4,2174.11,Lunna Caldeira,4,2,1,7,Regular
2161,44,6,7967.25,Emanuel Oliveira,2,3,4,9,Regular
2162,46,4,7681.91,Ana Liz Cardoso,2,2,4,8,Regular
2164,2,4,2505.48,Srta. Sofia Nogueira,4,2,2,8,Regular
2165,23,2,3911.94,Enzo Gabriel Aparecida,3,1,2,6,Ocasional
2166,44,6,6826.2699999999995,Marcelo Vasconcelos,2,3,3,8,Regular
2167,48,3,1686.9,Emanuel Ferreira,2,1,1,4,Ocasional
2168,10,10,6487.85,Eduardo Freitas,4,4,3,11,VIP
2169,16,2,1004.97,Dra. Ana Beatriz Câmara,4,1,1,6,Ocasional
2170,4,7,4402.62,Gael Castro,4,4,3,11,VIP
2171,85,2,829.3,Sr. Davi Cardoso,2,1,1,4,Ocasional
2172,150,6,3030.7,Maria Júlia Dias,1,3,2,6,Ocasional
2173,102,5,13719.18,Natália das Neves,1,3,4,8,Regular
2174,221,1,127.22,Pietro Fernandes,1,1,1,3,Inativo
2175,50,7,4822.87,Maria Fernanda da Conceição,2,4,3,9,Regular
2176,1,7,10930.5,Maria Liz da Cunha,4,4,4,12,VIP
2177,26,4,5302.19,Apollo Abreu,3,2,3,8,Regular
2178,23,4,4777.83,Srta. Ana Luiza Fogaça,3,2,3,8,Regular
2179,39,4,1867.27,Carlos Eduardo Pacheco,3,2,1,6,Ocasional
2180,19,2,4919.68,Nicole Porto,4,1,3,8,Regular
2181,10,6,3937.08,Eduardo Borges,4,3,2,9,Regular
2182,49,4,4686.150000000001,André da Rosa,2,2,3,7,Regular
2183,16,8,9405.22,Isaac Sá,4,4,4,12,VIP
2184,88,5,5693.51,Dra. Lavínia Lopes,1,3,3,7,Regular
2185,79,3,2280.0099999999998,Dra. Eloá Vasconcelos,2,1,2,5,Ocasional
2186,19,11,14721.07,Rafaela Cardoso,4,4,4,12,VIP
2187,1,7,6231.09,Eloá Novais,4,4,3,11,VIP
2188,38,6,8188.44,Dr. Enzo Gabriel Sá,3,3,4,10,VIP
2189,46,7,15967.41,Anthony Gabriel Borges,2,4,4,10,VIP
2190,32,7,15558.0,Alexia Viana,3,4,4,11,VIP
2191,158,5,5984.29,Maria Liz Abreu,1,3,3,7,Regular
2192,60,5,2930.15,Asafe Almeida,2,3,2,7,Regular
2193,2,3,4091.96,Vitor Gabriel Pinto,4,1,2,7,Regular
2194,53,6,5743.9400000000005,Augusto Leão,2,3,3,8,Regular
2195,13,6,5751.7699999999995,Brenda Rodrigues,4,3,3,10,VIP
2196,6,2,3394.07,Maria Albuquerque,4,1,2,7,Regular
2197,4,9,10104.380000000001,Mariana Ribeiro,4,4,4,12,VIP
2198,40,5,4936.68,José Pedro da Paz,3,3,3,9,Regular
2199,33,4,4114.37,João Pedro Camargo,3,2,2,7,Regular
2200,1,5,1697.62,Ana Beatriz Lima,4,3,1,8,Regular
2201,23,5,3436.12,Ana Lívia Melo,3,3,2,8,Regular
2202,1,8,4908.87,Esther Cavalcanti,4,4,3,11,VIP
2203,21,3,3572.37,Breno Vargas,3,1,2,6,Ocasional
2204,51,5,3904.56,Jade Machado,2,3,2,7,Regular
2205,171,3,1930.67,Otto Novais,1,1,1,3,Inativo
2206,16,8,18019.5,Benício Rezende,4,4,4,12,VIP
2207,33,8,15747.41,Erick Borges,3,4,4,11,VIP
2208,25,3,4681.01,Henry Mendes,3,1,3,7,Regular
2209,30,4,2806.27,Rafael Montenegro,3,2,2,7,Regular
2210,209,2,2245.13,Marcela Leão,1,1,1,3,Inativo
2211,47,7,19040.23,Léo Ribeiro,2,4,4,10,VIP
2212,33,5,5615.450000000001,Srta. Brenda Albuquerque,3,3,3,9,Regular
2213,79,1,150.01,Ana Beatriz Fernandes,2,1,1,4,Ocasional
2214,17,3,2379.5600000000004,Miguel Mendes,4,1,2,7,Regular
2215,2,4,7164.13,Fernando Leão,4,2,3,9,Regular
2216,8,8,8483.3,Milena Moraes,4,4,4,12,VIP
2217,54,1,96.16,Oliver Costela,2,1,1,4,Ocasional
2218,8,2,2039.98,Luna Almeida,4,1,1,6,Ocasional
2219,26,5,4862.43,Ana Vitória Nogueira,3,3,3,9,Regular
2220,21,11,16817.64,Bernardo Guerra,3,4,4,11,VIP
2221,20,6,7938.62,Anna Liz Rocha,3,3,4,10,VIP
2222,71,2,2121.31,Igor Martins,2,1,1,4,Ocasional
2223,11,11,20532.739999999998,Emanuel Alves,4,4,4,12,VIP
2224,8,3,6490.360000000001,Dr. Antony Camargo,4,1,3,8,Regular
2225,34,2,2337.98,Manuela Nascimento,3,1,2,6,Ocasional
2226,122,5,9766.1,Igor Novais,1,3,4,8,Regular
2227,5,6,10000.98,Olivia Montenegro,4,3,4,11,VIP
2228,74,8,11724.92,Vitória Pacheco,2,4,4,10,VIP
2229,212,1,2074.23,Sophia Borges,1,1,1,3,Inativo
2230,70,7,14783.07,Noah Pires,2,4,4,10,VIP
2231,196,2,219.57999999999998,Ana Luiza Marques,1,1,1,3,Inativo
2232,2,5,3550.79,Laís da Rosa,4,3,2,9,Regular
2233,41,5,2153.04,Kamilly Borges,3,3,1,7,Regular
2234,150,4,10704.810000000001,Brenda Cavalcante,1,2,4,7,Regular
2235,46,4,7751.71,Isaque Pinto,2,2,4,8,Regular
2236,4,6,5273.08,João Lucas da Mata,4,3,3,10,VIP
2237,205,2,2145.96,Raquel Abreu,1,1,1,3,Inativo
2238,15,2,550.89,Sr. Nicolas Peixoto,4,1,1,6,Ocasional
2239,28,6,4672.64,Yuri da Mata,3,3,3,9,Regular
2240,53,3,4466.88,Agatha Cardoso,2,1,3,6,Ocasional
2241,98,4,3934.8100000000004,Jade Montenegro,1,2,2,5,Ocasional
2242,14,6,2169.7,Murilo Sampaio,4,3,1,8,Regular
2243,211,3,962.0600000000001,Valentim Freitas,1,1,1,3,Inativo
2244,13,8,11544.289999999999,Nicole Pereira,4,4,4,12,VIP
2245,156,4,7312.7,Emanuella Carvalho,1,2,3,6,Ocasional
2246,52,4,8945.11,Anthony Gomes,2,2,4,8,Regular
2247,40,6,11410.49,Daniela Pastor,3,3,4,10,VIP
2248,151,2,1876.32,Milena Pimenta,1,1,1,3,Inativo
2249,193,3,564.89,Emanuella Aragão,1,1,1,3,Inativo
2250,123,3,539.0,Nathan Albuquerque,1,1,1,3,Inativo
2251,16,5,4110.72,Ana Lívia Vieira,4,3,2,9,Regular
2252,243,2,326.46000000000004,Valentim Oliveira,1,1,1,3,Inativo
2253,21,5,5075.54,Lunna Rios,3,3,3,9,Regular
2254,69,5,2308.35,Dra. Clarice Araújo,2,3,2,7,Regular
2255,15,5,1894.0,Bella Pinto,4,3,1,8,Regular
2256,27,7,2246.0,André Barros,3,4,1,8,Regular
2257,10,4,1360.01,Vinicius Lopes,4,2,1,7,Regular
2258,14,6,5567.66,Srta. Luiza Câmara,4,3,3,10,VIP
2259,202,2,4184.42,Sabrina Costa,1,1,2,4,Ocasional
2260,47,2,750.5,Emanuelly Aparecida,2,1,1,4,Ocasional
2261,69,4,7214.99,Gustavo Henrique Marques,2,2,3,7,Regular
2262,2,4,3022.37,Laura Novaes,4,2,2,8,Regular
2263,4,5,5553.97,Carolina Vasconcelos,4,3,3,10,VIP
2264,104,8,3964.44,Ana Sophia Viana,1,4,2,7,Regular
2265,51,4,11669.76,Eloah Nascimento,2,2,4,8,Regular
2266,9,5,5846.75,Luiz Gustavo Moraes,4,3,3,10,VIP
2267,37,7,10458.51,Dr. José Pedro da Mata,3,4,4,11,VIP
2268,15,6,7279.64,Agatha Aragão,4,3,3,10,VIP
2269,39,2,682.5,Josué Pereira,3,1,1,5,Ocasional
2270,37,5,2360.4,Elisa Vargas,3,3,2,8,Regular
2271,26,5,4737.74,Srta. Melina Nascimento,3,3,3,9,Regular
2272,342,1,289.17,Larissa Sales,1,1,1,3,Inativo
2273,73,4,10526.35,Caroline Costa,2,2,4,8,Regular
2274,48,7,3662.1800000000003,Raquel Aparecida,2,4,2,8,Regular
2275,39,5,7389.16,Dra. Ayla Nogueira,3,3,4,10,VIP
2276,49,8,7959.26,Dr. Yuri Fernandes,2,4,4,10,VIP
2277,33,7,8622.150000000001,Maria Luiza Andrade,3,4,4,11,VIP
2278,35,3,3254.0,Júlia Fonseca,3,1,2,6,Ocasional
2279,20,4,5663.429999999999,João Vitor Gomes,3,2,3,8,Regular
2280,285,3,4883.33,Maria Julia Jesus,1,1,3,5,Ocasional
2281,147,3,3883.97,Sr. Anthony Gabriel Carvalho,1,1,2,4,Ocasional
2282,74,6,7208.75,Melissa Abreu,2,3,3,8,Regular
2283,15,6,1683.17,Asafe Gonçalves,4,3,1,8,Regular
2284,75,5,8747.52,Aurora Ramos,2,3,4,9,Regular
2285,92,3,4641.46,Bárbara Cavalcante,1,1,3,5,Ocasional
2286,16,5,6799.04,Julia Fernandes,4,3,3,10,VIP
2287,215,2,1451.0,Daniel Oliveira,1,1,1,3,Inativo
2288,49,4,8228.2,Laís Ribeiro,2,2,4,8,Regular
2289,16,4,2876.25,Larissa Sales,4,2,2,8,Regular
2290,155,2,931.0200000000001,Yan Peixoto,1,1,1,3,Inativo
2291,21,6,3588.83,Dr. Nathan Castro,3,3,2,8,Regular
2292,68,6,4709.9400000000005,Maria Helena Albuquerque,2,3,3,8,Regular
2293,101,7,4034.8500000000004,Alexia da Rocha,1,4,2,7,Regular
2294,247,4,5531.53,Luiz Otávio Montenegro,1,2,3,6,Ocasional
2295,24,1,2647.36,Dra. Ayla Lima,3,1,2,6,Ocasional
2296,5,2,1309.96,Marcelo Cardoso,4,1,1,6,Ocasional
2298,50,7,12271.35,Sra. Ana Júlia Dias,2,4,4,10,VIP
2299,31,7,7110.54,Yasmin Gonçalves,3,4,3,10,VIP
2300,5,4,4276.17,Yuri da Costa,4,2,2,8,Regular
2301,145,5,6228.24,Alana Freitas,1,3,3,7,Regular
2302,17,6,7262.5199999999995,Aurora Nogueira,4,3,3,10,VIP
2303,14,9,12094.73,Rebeca da Costa,4,4,4,12,VIP
2304,98,3,2900.41,Maria Luiza da Rocha,1,1,2,4,Ocasional
2305,145,3,3505.2,Maria Flor Pinto,1,1,2,4,Ocasional
2306,29,8,8390.16,Dra. Maitê Rezende,3,4,4,11,VIP
2307,54,7,13403.859999999999,Srta. Ana Luiza Lima,2,4,4,10,VIP
2308,21,8,17788.98,Ana Sophia Pereira,3,4,4,11,VIP
2309,42,5,3113.27,Sra. Carolina Gomes,3,3,2,8,Regular
2310,26,1,786.73,Arthur Abreu,3,1,1,5,Ocasional
2311,31,3,3683.94,Clarice Cardoso,3,1,2,6,Ocasional
2312,47,5,4752.969999999999,Dra. Ana Beatriz Gonçalves,2,3,3,8,Regular
2313,149,3,897.95,Sr. Isaac Garcia,1,1,1,3,Inativo
2314,42,3,10924.470000000001,Renan Vieira,3,1,4,8,Regular
2315,181,6,9475.74,Maria Clara Montenegro,1,3,4,8,Regular
2316,47,2,2022.26,Eduarda Albuquerque,2,1,1,4,Ocasional
2317,7,13,19654.16,Ana Sophia da Paz,4,4,4,12,VIP
2318,36,8,10795.95,Ryan Souza,3,4,4,11,VIP
2319,3,5,2830.99,Dr. Anthony Gabriel da Paz,4,3,2,9,Regular
2320,38,3,410.64,Jade Garcia,3,1,1,5,Ocasional
2321,126,6,15575.150000000001,Lucca da Conceição,1,3,4,8,Regular
2322,1,9,15512.51,Davi Miguel Correia,4,4,4,12,VIP
2323,25,6,4327.120000000001,Dra. Rebeca Azevedo,3,3,2,8,Regular
2324,28,4,1955.87,Bernardo Gomes,3,2,1,6,Ocasional
2325,54,5,8108.64,Maria Eduarda Guerra,2,3,4,9,Regular
2326,76,5,3243.54,Mariane Rodrigues,2,3,2,7,Regular
2327,3,5,5765.96,Melina Cassiano,4,3,3,10,VIP
2328,38,6,984.03,Maria Liz Cardoso,3,3,1,7,Regular
2329,26,5,11319.119999999999,Lucas Monteiro,3,3,4,10,VIP
2330,40,3,1321.74,Kamilly Abreu,3,1,1,5,Ocasional
2331,93,5,8404.26,Caroline da Rocha,1,3,4,8,Regular
2332,79,3,3552.4399999999996,José Miguel da Rosa,2,1,2,5,Ocasional
2333,113,3,3366.66,Guilherme Moura,1,1,2,4,Ocasional
2334,49,4,6092.81,Benício Machado,2,2,3,7,Regular
2335,6,6,7231.650000000001,Eduardo Cunha,4,3,3,10,VIP
2336,14,7,15175.980000000001,Heloisa Alves,4,4,4,12,VIP
2337,43,7,7520.849999999999,Renan Peixoto,3,4,4,11,VIP
2338,3,7,7282.86,Luiz Miguel Gomes,4,4,3,11,VIP
2339,2,5,3175.9700000000003,Rebeca da Rosa,4,3,2,9,Regular
2340,31,3,3540.2999999999997,Sr. Davi Miguel Ribeiro,3,1,2,6,Ocasional
2341,85,4,3047.04,Igor Borges,2,2,2,6,Ocasional
2342,27,7,7186.86,Eduardo Aparecida,3,4,3,10,VIP
2343,132,2,823.97,Natália Fonseca,1,1,1,3,Inativo
2344,88,3,1901.65,Guilherme Abreu,1,1,1,3,Inativo
2345,6,3,4405.57,Otto Castro,4,1,3,8,Regular
2346,8,5,5189.950000000001,Maria Flor Silva,4,3,3,10,VIP
2347,120,5,3572.0600000000004,Evelyn Sampaio,1,3,2,6,Ocasional
2348,126,3,5127.55,Marcelo Borges,1,1,3,5,Ocasional
2349,13,4,1050.6000000000001,Maria Cecília Fernandes,4,2,1,7,Regular
2350,224,1,173.98,Cecília Câmara,1,1,1,3,Inativo
2351,12,3,3071.13,Ana Laura Andrade,4,1,2,7,Regular
2352,15,3,10015.38,Melissa Pacheco,4,1,4,9,Regular
2353,31,8,10813.4,Yago Nogueira,3,4,4,11,VIP
2354,33,4,2830.37,Ana Laura Novais,3,2,2,7,Regular
2355,115,3,502.64,Julia Novaes,1,1,1,3,Inativo
2356,145,5,10473.26,Anna Liz Cassiano,1,3,4,8,Regular
2357,174,2,5872.93,Ana Pires,1,1,3,5,Ocasional
2358,164,3,1461.05,Maria Julia Rezende,1,1,1,3,Inativo
2359,21,7,5950.7,Ana Carolina Campos,3,4,3,10,VIP
2360,46,4,8422.19,Isabel Câmara,2,2,4,8,Regular
2361,41,7,6413.83,Rebeca Duarte,3,4,3,10,VIP
2362,65,2,3319.1400000000003,Alice Mendonça,2,1,2,5,Ocasional
2363,80,5,5385.32,Dr. Asafe Rodrigues,2,3,3,8,Regular
2364,2,5,10777.619999999999,Hellena Moreira,4,3,4,11,VIP
2365,269,1,1304.8,Leonardo Azevedo,1,1,1,3,Inativo
2366,19,6,4433.360000000001,Gael Henrique Guerra,4,3,3,10,VIP
2367,41,4,2337.81,Pedro Lucas Machado,3,2,2,7,Regular
2368,250,1,2477.01,Juliana Fogaça,1,1,2,4,Ocasional
2369,118,3,4079.43,Otávio Silveira,1,1,2,4,Ocasional
2370,51,7,9375.08,Theo Montenegro,2,4,4,10,VIP
2371,65,3,7576.299999999999,Clara Ribeiro,2,1,4,7,Regular
2372,78,3,1485.75,Aurora Farias,2,1,1,4,Ocasional
2373,17,6,4121.08,Sra. Ana Lívia Novaes,4,3,2,9,Regular
2374,1,3,2659.3,João Vitor Vieira,4,1,2,7,Regular
2375,58,5,6943.2,Maria Alice Nogueira,2,3,3,8,Regular
2376,49,5,13582.25,Sr. Enrico Cavalcante,2,3,4,9,Regular
2377,111,7,2921.56,Ian Viana,1,4,2,7,Regular
2378,225,1,553.88,Gabrielly Sales,1,1,1,3,Inativo
2379,48,5,2932.32,Vitor Gabriel Guerra,2,3,2,7,Regular
2380,40,3,2114.8,Dra. Maria Isis Santos,3,1,1,5,Ocasional
2381,17,7,18994.88,Sra. Maria Vitória Jesus,4,4,4,12,VIP
2382,99,9,10232.26,Davi Luiz Vieira,1,4,4,9,Regular
2383,211,3,4177.85,Brayan Costela,1,1,2,4,Ocasional
2384,87,4,2681.43,Renan Machado,2,2,2,6,Ocasional
2385,82,10,9556.14,Enzo Cunha,2,4,4,10,VIP
2386,17,8,8779.66,Marcos Vinicius Aragão,4,4,4,12,VIP
2387,222,5,5779.66,Maria Alice Sousa,1,3,3,7,Regular
2388,224,2,531.96,Maysa Garcia,1,1,1,3,Inativo
2389,126,1,627.13,Luna Abreu,1,1,1,3,Inativo
2390,77,2,7393.54,Jade Novaes,2,1,4,7,Regular
2391,10,9,8688.48,Igor Azevedo,4,4,4,12,VIP
2392,58,2,830.75,Fernanda Cassiano,2,1,1,4,Ocasional
2393,178,2,1475.84,Sr. Benício Carvalho,1,1,1,3,Inativo
2394,62,2,3266.55,Mariana Brito,2,1,2,5,Ocasional
2395,159,2,2543.7799999999997,Dra. Pietra da Cruz,1,1,2,4,Ocasional
2396,55,2,4569.4,Ian Lopes,2,1,3,6,Ocasional
2397,53,4,10024.929999999998,Yan Marques,2,2,4,8,Regular
2398,112,3,2338.7999999999997,Ana Júlia Jesus,1,1,2,4,Ocasional
2399,14,3,7584.16,Dr. Felipe Santos,4,1,4,9,Regular
2400,64,3,3445.8099999999995,Marina Farias,2,1,2,5,Ocasional
2401,39,3,1111.78,Apollo Guerra,3,1,1,5,Ocasional
2402,13,6,5389.58,Cecília Almeida,4,3,3,10,VIP
2403,71,4,1982.12,Davi Luiz da Mota,2,2,1,5,Ocasional
2404,208,3,1057.91,Dr. Davi Miguel Rezende,1,1,1,3,Inativo
2405,36,5,7514.72,Gustavo Henrique Câmara,3,3,4,10,VIP
2406,17,5,5254.66,Heitor Castro,4,3,3,10,VIP
2407,71,2,3833.41,Maria Liz da Rosa,2,1,2,5,Ocasional
2408,53,3,4358.54,Erick Souza,2,1,2,5,Ocasional
2409,284,1,2636.9,Isabelly da Mota,1,1,2,4,Ocasional
2410,15,3,1142.2,Maria Luiza Freitas,4,1,1,6,Ocasional
2411,40,7,7991.53,Sophia Araújo,3,4,4,11,VIP
2412,24,4,1397.7,Maria Eduarda Castro,3,2,1,6,Ocasional
2413,110,5,1732.38,Maria Luísa Cardoso,1,3,1,5,Ocasional
2414,2,7,8217.11,Dr. Bruno Castro,4,4,4,12,VIP
2415,24,4,5519.46,Lorenzo da Mata,3,2,3,8,Regular
2416,46,5,5048.21,Noah Viana,2,3,3,8,Regular
2417,6,6,11637.800000000001,Ísis Viana,4,3,4,11,VIP
2418,93,4,2384.21,Sophie Rezende,1,2,2,5,Ocasional
2419,101,4,7056.03,Caroline Garcia,1,2,3,6,Ocasional
2420,69,4,10040.9,Allana Novais,2,2,4,8,Regular
2421,55,4,2815.41,Miguel Viana,2,2,2,6,Ocasional
2422,51,5,1624.44,Enzo Gomes,2,3,1,6,Ocasional
2423,33,5,10508.619999999999,Letícia Albuquerque,3,3,4,10,VIP
2424,183,5,5895.33,Maria Isis Silva,1,3,3,7,Regular
2425,62,2,4698.219999999999,Heloisa Cunha,2,1,3,6,Ocasional
2426,110,4,6410.86,Ana Camargo,1,2,3,6,Ocasional
2427,143,1,94.13,Gael Câmara,1,1,1,3,Inativo
2428,52,2,3289.21,João Guilherme Nascimento,2,1,2,5,Ocasional
2429,46,3,11442.79,Helena Andrade,2,1,4,7,Regular
2430,159,4,14941.32,Antonella Vargas,1,2,4,7,Regular
2431,41,4,4582.33,Maria Vitória Campos,3,2,3,8,Regular
2432,186,1,268.33,Diego Campos,1,1,1,3,Inativo
2433,239,1,2348.19,Gustavo Henrique Dias,1,1,2,4,Ocasional
2434,39,5,1497.64,Beatriz Costela,3,3,1,7,Regular
2435,72,6,11390.54,Gustavo Carvalho,2,3,4,9,Regular
2436,22,9,10251.03,Enrico Moreira,3,4,4,11,VIP
2437,30,3,943.67,Liam Carvalho,3,1,1,5,Ocasional
2438,4,8,4270.0599999999995,Dr. Mateus da Rocha,4,4,2,10,VIP
2439,152,3,1579.95,Theo da Rosa,1,1,1,3,Inativo
2440,2,3,2902.39,Dr. Benicio Barbosa,4,1,2,7,Regular
2441,11,3,1563.02,Ester Gomes,4,1,1,6,Ocasional
2442,35,6,3929.58,Sara Sousa,3,3,2,8,Regular
2443,99,4,9452.539999999999,Sra. Ágatha Peixoto,1,2,4,7,Regular
2444,113,1,1038.34,Hellena Araújo,1,1,1,3,Inativo
2445,51,4,3455.58,Giovanna Fonseca,2,2,2,6,Ocasional
2446,47,5,9671.26,Maria Luiza Carvalho,2,3,4,9,Regular
2447,27,5,7904.29,Juan Rezende,3,3,4,10,VIP
2448,10,2,2067.16,Melina Vasconcelos,4,1,1,6,Ocasional
2449,158,4,3738.12,Carlos Eduardo Mendonça,1,2,2,5,Ocasional
2450,41,6,7560.68,Davi Ferreira,3,3,4,10,VIP
2451,49,4,12324.65,Anthony Gabriel Nascimento,2,2,4,8,Regular
2452,3,4,2515.06,Arthur Gabriel Abreu,4,2,2,8,Regular
2453,210,6,5311.4800000000005,Danilo da Cruz,1,3,3,7,Regular
2454,7,5,7576.87,Caroline Abreu,4,3,4,11,VIP
2455,7,4,2008.3400000000001,Valentina da Costa,4,2,1,7,Regular
2456,123,5,11353.119999999999,Lucas da Cruz,1,3,4,8,Regular
2457,70,5,7279.04,Maria Luísa Marques,2,3,3,8,Regular
2458,261,1,457.93,Heloisa Almeida,1,1,1,3,Inativo
2459,2,6,7429.030000000001,Heloísa Martins,4,3,4,11,VIP
2460,57,6,6624.64,Sra. Isis da Costa,2,3,3,8,Regular
2461,91,4,1900.48,Maria Fernanda Pastor,1,2,1,4,Ocasional
2462,194,1,3830.44,Ana Julia Sales,1,1,2,4,Ocasional
2463,46,3,1695.3600000000001,Luísa Leão,2,1,1,4,Ocasional
2464,254,2,9359.64,Sr. Pedro Miguel Leão,1,1,4,6,Ocasional
2465,29,4,3176.34,Davi Miguel Fogaça,3,2,2,7,Regular
2466,21,3,3024.4700000000003,Elisa Porto,3,1,2,6,Ocasional
2467,76,4,1752.28,Vitor da Paz,2,2,1,5,Ocasional
2468,35,6,4481.16,João Guilherme Barros,3,3,3,9,Regular
2469,91,3,7076.57,Bianca Duarte,1,1,3,5,Ocasional
2470,14,7,22721.87,Maria Flor Albuquerque,4,4,4,12,VIP
2471,191,3,6049.6,Cecília Pinto,1,1,3,5,Ocasional
2472,26,2,1190.65,Vinicius Gomes,3,1,1,5,Ocasional
2473,6,7,5707.4,Dra. Ayla Macedo,4,4,3,11,VIP
2474,17,7,7093.71,Kevin Borges,4,4,3,11,VIP
2475,192,4,5388.1900000000005,Nathan Garcia,1,2,3,6,Ocasional
2476,154,2,3938.57,Henrique Campos,1,1,2,4,Ocasional
2477,8,3,5284.2699999999995,Otto Brito,4,1,3,8,Regular
2478,5,6,3106.08,Raquel Barros,4,3,2,9,Regular
2479,17,5,9404.85,Dr. Carlos Eduardo Garcia,4,3,4,11,VIP
2480,11,7,9533.39,Dr. Leonardo Abreu,4,4,4,12,VIP
2481,22,6,2970.1,Sr. Davi Luiz Souza,3,3,2,8,Regular
2482,2,3,4406.15,Lucas Garcia,4,1,3,8,Regular
2483,26,6,4202.99,Luiz Gustavo Costa,3,3,2,8,Regular
2484,2,5,6350.0199999999995,Ravy Ramos,4,3,3,10,VIP
2485,135,4,3264.39,Luna Mendes,1,2,2,5,Ocasional
2486,328,1,698.62,Bruna Gonçalves,1,1,1,3,Inativo
2487,2,5,1455.4699999999998,Mariane Costela,4,3,1,8,Regular
2488,8,7,7823.87,Davi Miguel Garcia,4,4,4,12,VIP
2489,47,5,2042.21,Luana Correia,2,3,1,6,Ocasional
2490,336,2,1288.67,Vitor Gabriel Nunes,1,1,1,3,Inativo
2491,17,9,7327.53,Dr. Mateus Pimenta,4,4,4,12,VIP
2492,76,6,6823.64,Sara Jesus,2,3,3,8,Regular
2493,30,4,3026.31,Arthur Gomes,3,2,2,7,Regular
2494,15,6,5483.63,Léo Azevedo,4,3,3,10,VIP
2495,11,7,4865.06,Maria Clara Rocha,4,4,3,11,VIP
2496,52,2,504.54,Paulo Castro,2,1,1,4,Ocasional
2497,60,6,11080.61,Levi Abreu,2,3,4,9,Regular
2498,22,2,619.01,Diego Rocha,3,1,1,5,Ocasional
2499,6,6,7730.320000000001,Liam Sampaio,4,3,4,11,VIP
2500,94,2,1503.38,Brayan Cardoso,1,1,1,3,Inativo
2501,19,3,4559.799999999999,Thales Martins,4,1,3,8,Regular
2502,72,3,4784.75,Benjamim Marques,2,1,3,6,Ocasional
2503,39,6,7509.99,Cecília Vasconcelos,3,3,4,10,VIP
2504,292,1,350.26,Dra. Júlia Dias,1,1,1,3,Inativo
2505,4,4,6413.610000000001,Hellena Rios,4,2,3,9,Regular
2506,97,2,3535.59,Apollo Aragão,1,1,2,4,Ocasional
2507,142,2,2635.13,Otávio Machado,1,1,2,4,Ocasional
2508,32,3,1838.21,Antonella Sampaio,3,1,1,5,Ocasional
2509,98,3,3892.7999999999997,Catarina Alves,1,1,2,4,Ocasional
2510,13,8,9359.25,Maria Eduarda Teixeira,4,4,4,12,VIP
2511,8,2,3203.2000000000003,Dr. Matteo Camargo,4,1,2,7,Regular
2512,17,8,3040.93,Sophia Oliveira,4,4,2,10,VIP
2513,40,6,6391.41,Benício Ferreira,3,3,3,9,Regular
2514,18,5,2053.35,Vicente Porto,4,3,1,8,Regular
2515,49,4,1082.6799999999998,Sr. Gael Henrique Aparecida,2,2,1,5,Ocasional
2516,30,4,2589.14,Julia Andrade,3,2,2,7,Regular
2517,41,3,3076.06,Valentina Sales,3,1,2,6,Ocasional
2518,16,2,1170.79,Mariana Moreira,4,1,1,6,Ocasional
2519,4,4,6052.4400000000005,Dra. Gabriela Ribeiro,4,2,3,9,Regular
2520,47,3,2624.73,Sr. Marcelo Correia,2,1,2,5,Ocasional
2521,23,4,5538.23,Maria Eduarda da Cruz,3,2,3,8,Regular
2522,16,4,3318.83,Cecília Brito,4,2,2,8,Regular
2523,28,5,5325.56,Juliana Lima,3,3,3,9,Regular
2524,51,4,9213.85,André Cassiano,2,2,4,8,Regular
2525,325,1,350.74,Hellena da Cunha,1,1,1,3,Inativo
2526,29,12,14913.84,Bianca da Costa,3,4,4,11,VIP
2527,47,4,10798.2,Anthony Porto,2,2,4,8,Regular
2528,19,6,7391.69,Bruna Campos,4,3,4,11,VIP
2529,22,4,4920.9,Ana Liz Albuquerque,3,2,3,8,Regular
2530,8,5,9482.619999999999,Gael da Rocha,4,3,4,11,VIP
2531,21,3,4875.179999999999,Paulo Campos,3,1,3,7,Regular
2532,85,3,6001.72,Laís Aparecida,2,1,3,6,Ocasional
2533,14,8,7499.209999999999,Sra. Clarice Castro,4,4,4,12,VIP
2534,20,4,6592.01,Breno Teixeira,3,2,3,8,Regular
2535,41,6,10450.01,Isabelly Leão,3,3,4,10,VIP
2536,75,4,4391.92,Sr. Calebe Aparecida,2,2,3,7,Regular
2537,24,4,2737.33,Marcela Novais,3,2,2,7,Regular
2538,279,2,3354.62,Sarah Silva,1,1,2,4,Ocasional
2539,117,4,2490.94,Ayla da Cunha,1,2,2,5,Ocasional
2540,29,10,7455.419999999999,Eduardo Almeida,3,4,4,11,VIP
2541,31,5,6620.07,Valentim Casa Grande,3,3,3,9,Regular
2542,162,3,5853.49,Alexandre Aparecida,1,1,3,5,Ocasional
2543,59,2,2774.31,Sra. Allana Dias,2,1,2,5,Ocasional
2544,27,6,14942.24,Murilo Rezende,3,3,4,10,VIP
2545,51,5,6156.13,Helena Garcia,2,3,3,8,Regular
2546,44,3,2012.0,Isabela Azevedo,2,1,1,4,Ocasional
2547,30,4,4504.29,Erick Moura,3,2,3,8,Regular
2548,58,4,5340.39,Emilly Pinto,2,2,3,7,Regular
2549,47,6,5954.320000000001,Aurora da Cruz,2,3,3,8,Regular
2550,84,2,6191.75,Davi Miguel Rocha,2,1,3,6,Ocasional
2551,109,2,312.43,Agatha Ferreira,1,1,1,3,Inativo
2552,358,1,1201.09,Srta. Alexia Pimenta,1,1,1,3,Inativo
2553,68,4,802.56,Davi Souza,2,2,1,5,Ocasional
2554,8,4,2399.77,Srta. Maria Luiza Mendonça,4,2,2,8,Regular
2555,59,6,12360.16,Helena Jesus,2,3,4,9,Regular
2556,295,2,383.82,Elisa Marques,1,1,1,3,Inativo
2557,29,4,3492.34,Sophie Albuquerque,3,2,2,7,Regular
2558,12,4,4745.700000000001,Yan Ramos,4,2,3,9,Regular
2559,111,6,13074.87,Lorenzo Fernandes,1,3,4,8,Regular
2560,14,8,8076.82,Esther Novais,4,4,4,12,VIP
2561,43,9,8890.41,Bianca Vasconcelos,3,4,4,11,VIP
2562,34,4,3404.9700000000003,Luiz Gustavo Gonçalves,3,2,2,7,Regular
2563,13,6,7469.35,Vinicius Lima,4,3,4,11,VIP
2564,7,5,5844.26,Fernando Moreira,4,3,3,10,VIP
2565,16,3,5640.55,Gael Henrique Almeida,4,1,3,8,Regular
2566,24,2,428.86,Ana Carolina Monteiro,3,1,1,5,Ocasional
2567,64,5,5871.92,Nicolas Pereira,2,3,3,8,Regular
2568,3,5,2989.2200000000003,Theo Porto,4,3,2,9,Regular
2569,5,9,12672.56,José Pedro Sampaio,4,4,4,12,VIP
2570,28,9,16136.69,Srta. Kamilly das Neves,3,4,4,11,VIP
2571,43,3,4224.07,Ágatha Monteiro,3,1,2,6,Ocasional
2572,31,6,4438.75,João Lucas Garcia,3,3,3,9,Regular
2573,7,4,2238.09,Thiago Costa,4,2,1,7,Regular
2574,18,5,3868.74,Maria Júlia da Rosa,4,3,2,9,Regular
2575,202,5,13460.300000000001,Lavínia da Cruz,1,3,4,8,Regular
2576,22,5,11197.239999999998,Joaquim Siqueira,3,3,4,10,VIP
2577,4,5,6547.530000000001,Liam Araújo,4,3,3,10,VIP
2578,71,4,10065.15,Benjamim Marques,2,2,4,8,Regular
2579,113,2,4590.05,Heloísa Sousa,1,1,3,5,Ocasional
2580,296,1,259.79,Alana da Costa,1,1,1,3,Inativo
2581,34,3,1293.92,Caroline Sales,3,1,1,5,Ocasional
2582,66,2,1697.3600000000001,Sr. Benício Carvalho,2,1,1,4,Ocasional
2583,48,3,2758.0600000000004,Sr. Bruno Silveira,2,1,2,5,Ocasional
2584,26,8,12668.32,Murilo Fogaça,3,4,4,11,VIP
2585,49,3,2825.72,Sr. Benjamim Moura,2,1,2,5,Ocasional
2586,80,6,4981.74,Pedro Aparecida,2,3,3,8,Regular
2587,28,2,1291.81,Luiz Felipe Fogaça,3,1,1,5,Ocasional
2588,2,6,4499.57,Oliver Marques,4,3,3,10,VIP
2589,12,4,2120.83,Maria Fernanda Lima,4,2,1,7,Regular
2590,56,4,3785.93,Vinicius Campos,2,2,2,6,Ocasional
2591,80,1,77.97,Marina da Costa,2,1,1,4,Ocasional
2592,92,2,2299.0699999999997,Leonardo Farias,1,1,2,4,Ocasional
2593,92,7,14974.68,Maysa da Conceição,1,4,4,9,Regular
2594,39,7,10116.75,Ana Carolina das Neves,3,4,4,11,VIP
2595,30,3,2322.24,Letícia Fonseca,3,1,2,6,Ocasional
2596,61,5,5254.290000000001,José Miguel Cardoso,2,3,3,8,Regular
2597,64,3,2041.31,Daniel Silva,2,1,1,4,Ocasional
2598,10,5,2927.12,Gabriela Ramos,4,3,2,9,Regular
2599,7,5,6406.27,Eduarda Rios,4,3,3,10,VIP
2600,227,2,5173.8,Bruna Rocha,1,1,3,5,Ocasional
2601,76,6,6253.17,Brenda Lima,2,3,3,8,Regular
2602,84,5,5074.26,Isadora Gonçalves,2,3,3,8,Regular
2603,179,2,1562.19,Bruna Vargas,1,1,1,3,Inativo
2604,5,8,8073.3099999999995,Sr. Marcelo Costa,4,4,4,12,VIP
2605,107,3,874.11,Davi Lucca Vasconcelos,1,1,1,3,Inativo
2606,85,4,9382.37,Heitor Souza,2,2,4,8,Regular
2607,24,5,4638.18,Isaac Rezende,3,3,3,9,Regular
2608,92,5,9151.71,Marcela da Rosa,1,3,4,8,Regular
2609,33,6,3282.06,Yan Rios,3,3,2,8,Regular
2610,28,7,17158.86,João Lucas Garcia,3,4,4,11,VIP
2611,19,6,5591.6900000000005,Eloá Fonseca,4,3,3,10,VIP
2612,158,3,2010.1599999999999,Maria Julia Moreira,1,1,1,3,Inativo
2613,21,9,13710.29,Aurora Rezende,3,4,4,11,VIP
2614,132,6,13255.5,Sra. Raquel Lima,1,3,4,8,Regular
2615,44,5,7045.67,Dra. Beatriz Vasconcelos,2,3,3,8,Regular
2616,2,3,1924.42,Sr. Vitor Pereira,4,1,1,6,Ocasional
2617,25,7,15014.44,Bruno Pinto,3,4,4,11,VIP
2618,140,2,5266.79,Dr. Mathias Camargo,1,1,3,5,Ocasional
2619,50,7,17356.98,Bruna Sales,2,4,4,10,VIP
2620,77,3,3705.87,Murilo Teixeira,2,1,2,5,Ocasional
2621,39,3,4138.28,Raul Brito,3,1,2,6,Ocasional
2622,40,9,7419.96,Laura Rios,3,4,4,11,VIP
2623,127,6,8016.009999999999,Srta. Agatha da Rocha,1,3,4,8,Regular
2624,56,8,4890.45,Bella Freitas,2,4,3,9,Regular
2625,38,7,7014.8099999999995,Sra. Giovanna Leão,3,4,3,10,VIP
2626,243,2,5588.13,Rafaela Almeida,1,1,3,5,Ocasional
2627,7,3,5845.36,Ryan Rodrigues,4,1,3,8,Regular
2628,297,1,2818.52,Diogo Vasconcelos,1,1,2,4,Ocasional
2629,145,2,768.4200000000001,Benício Aparecida,1,1,1,3,Inativo
2630,14,1,618.3,Théo Castro,4,1,1,6,Ocasional
2631,20,6,5757.75,Dra. Maria Liz Rezende,3,3,3,9,Regular
2632,59,1,2805.47,Dra. Isis Oliveira,2,1,2,5,Ocasional
2633,70,2,423.78999999999996,Cauê Mendonça,2,1,1,4,Ocasional
2634,102,4,11428.67,Srta. Yasmin Ribeiro,1,2,4,7,Regular
2635,53,2,1265.84,Sra. Maria Luísa da Cruz,2,1,1,4,Ocasional
2636,281,2,2407.9,Dr. Pietro Cavalcanti,1,1,2,4,Ocasional
2637,141,6,8645.44,Sofia Barbosa,1,3,4,8,Regular
2638,20,4,8979.22,Benicio Camargo,3,2,4,9,Regular
2639,24,6,8913.039999999999,Srta. Bruna Gomes,3,3,4,10,VIP
2640,23,4,4201.599999999999,Luísa da Mata,3,2,2,7,Regular
2641,72,4,2843.52,Maria Alice Souza,2,2,2,6,Ocasional
2642,33,5,7681.07,Yan Teixeira,3,3,4,10,VIP
2643,83,3,1881.47,Dr. Cauê Macedo,2,1,1,4,Ocasional
2644,48,7,9871.91,Thales Leão,2,4,4,10,VIP
2645,51,5,741.6,Dra. Maria Laura da Conceição,2,3,1,6,Ocasional
2646,58,3,5139.280000000001,Benjamim Pereira,2,1,3,6,Ocasional
2647,39,6,4301.4400000000005,Paulo Sampaio,3,3,2,8,Regular
2648,3,4,3139.01,Felipe Sampaio,4,2,2,8,Regular
2649,9,4,3540.92,Otto Guerra,4,2,2,8,Regular
2650,11,5,6055.6,Srta. Bárbara Mendes,4,3,3,10,VIP
2651,16,8,12194.84,Eloá Sousa,4,4,4,12,VIP
2652,73,3,1477.3799999999999,Francisco Siqueira,2,1,1,4,Ocasional
2653,61,4,8411.77,João Vitor da Mata,2,2,4,8,Regular
2654,11,7,3305.49,Léo Abreu,4,4,2,10,VIP
2655,185,2,987.75,Ana Luiza Fernandes,1,1,1,3,Inativo
2656,29,4,4843.97,Ágatha Pinto,3,2,3,8,Regular
2657,30,2,6260.91,Benjamin Moraes,3,1,3,7,Regular
2658,54,1,160.34,Luiza Pimenta,2,1,1,4,Ocasional
2659,21,3,1996.4,Maria Helena Lopes,3,1,1,5,Ocasional
2660,12,3,6007.69,Isis Borges,4,1,3,8,Regular
2661,43,7,8042.0,Davi Lucas da Mota,3,4,4,11,VIP
2662,54,2,1059.6599999999999,Nicolas Correia,2,1,1,4,Ocasional
2663,1,5,6170.59,Sr. Vinicius Garcia,4,3,3,10,VIP
2664,21,3,1747.53,Dr. Erick da Paz,3,1,1,5,Ocasional
2665,9,4,2240.58,Juliana Costela,4,2,1,7,Regular
2666,11,4,9501.38,Josué Nunes,4,2,4,10,VIP
2667,38,5,12522.75,Maria Luiza Farias,3,3,4,10,VIP
2668,25,5,2242.1,Manuela da Mota,3,3,1,7,Regular
2669,99,2,9210.63,Maria Liz Rios,1,1,4,6,Ocasional
2670,111,6,7173.939999999999,Allana Jesus,1,3,3,7,Regular
2671,43,3,1953.6000000000001,Bruno Alves,3,1,1,5,Ocasional
2672,145,7,12286.710000000001,Dr. Pedro Siqueira,1,4,4,9,Regular
2673,20,5,4855.44,José Pedro Nunes,3,3,3,9,Regular
2674,63,4,2444.92,Stella Duarte,2,2,2,6,Ocasional
2675,35,5,2034.41,Heloísa Mendonça,3,3,1,7,Regular
2676,273,1,4287.13,Dra. Eloah Farias,1,1,2,4,Ocasional
2677,8,9,7483.110000000001,Isabella Nascimento,4,4,4,12,VIP
2678,3,6,4647.25,Valentim Ramos,4,3,3,10,VIP
2679,16,2,3920.46,Bryan Almeida,4,1,2,7,Regular
2680,84,5,4119.360000000001,Giovanna Abreu,2,3,2,7,Regular
2681,64,5,4747.360000000001,Ana Julia Cunha,2,3,3,8,Regular
2682,78,3,4077.87,Kevin Rodrigues,2,1,2,5,Ocasional
2683,364,1,1161.17,Dom Costa,1,1,1,3,Inativo
2684,141,2,3038.3900000000003,Pietro Câmara,1,1,2,4,Ocasional
2685,31,6,4386.52,Catarina Gomes,3,3,3,9,Regular
2686,57,1,432.06,Rebeca Monteiro,2,1,1,4,Ocasional
2687,35,4,4805.63,Sra. Cecilia Pastor,3,2,3,8,Regular
2688,9,4,4907.0,Nina Leão,4,2,3,9,Regular
2689,11,4,6069.22,Sr. Leandro Peixoto,4,2,3,9,Regular
2690,79,3,6204.320000000001,Gustavo Henrique Araújo,2,1,3,6,Ocasional
2691,123,6,15857.319999999998,Maria Fernanda Gonçalves,1,3,4,8,Regular
2692,27,6,2924.34,Dr. Luiz Otávio da Cruz,3,3,2,8,Regular
2693,129,3,2294.59,Bruno Azevedo,1,1,2,4,Ocasional
2694,1,6,7495.84,Sarah Nunes,4,3,4,11,VIP
2695,20,3,913.77,Sra. Kamilly Guerra,3,1,1,5,Ocasional
2696,140,5,2653.38,Maria Luísa Moraes,1,3,2,6,Ocasional
2697,41,2,95.22,Maria Isis Novaes,3,1,1,5,Ocasional
2698,14,4,3405.6299999999997,Maria Fernanda Almeida,4,2,2,8,Regular
2699,24,7,5689.18,Francisco Monteiro,3,4,3,10,VIP
2700,77,3,1966.36,Eduardo Azevedo,2,1,1,4,Ocasional
2701,33,3,8502.12,Ryan das Neves,3,1,4,8,Regular
2702,83,4,2402.32,Maitê Cavalcante,2,2,2,6,Ocasional
2703,39,2,10080.67,Cauã Almeida,3,1,4,8,Regular
2704,31,5,8549.51,Vitor Gabriel Souza,3,3,4,10,VIP
2705,4,7,4072.28,Luiz Otávio Barbosa,4,4,2,10,VIP
2706,11,7,5653.7699999999995,Anna Liz Ferreira,4,4,3,11,VIP
2707,9,6,11674.0,Lunna Fernandes,4,3,4,11,VIP
2708,42,2,1951.74,Dr. Valentim Camargo,3,1,1,5,Ocasional
2709,267,2,1501.17,Henry das Neves,1,1,1,3,Inativo
2710,77,3,2727.45,Matheus Correia,2,1,2,5,Ocasional
2711,34,4,3879.12,Dr. Isaque Teixeira,3,2,2,7,Regular
2712,30,3,1734.18,Juan Borges,3,1,1,5,Ocasional
2713,240,2,7312.0,Maria Alice Fonseca,1,1,3,5,Ocasional
2714,16,8,9642.59,Juan Albuquerque,4,4,4,12,VIP
2715,58,4,8823.02,Sra. Maria Cecília Pimenta,2,2,4,8,Regular
2716,36,5,7710.67,Dante Viana,3,3,4,10,VIP
2717,156,3,3730.38,Antonella Pinto,1,1,2,4,Ocasional
2718,48,5,3908.62,Bento Sá,2,3,2,7,Regular
2719,137,2,2988.9,Oliver Montenegro,1,1,2,4,Ocasional
2720,148,2,1503.23,Maria Helena Casa Grande,1,1,1,3,Inativo
2721,166,1,2470.58,Alexandre Albuquerque,1,1,2,4,Ocasional
2722,14,5,4541.38,Ana Julia Santos,4,3,3,10,VIP
2723,90,1,769.74,Lucca Pimenta,1,1,1,3,Inativo
2724,108,4,1353.15,Luiz Fernando Borges,1,2,1,4,Ocasional
2725,26,3,2425.0299999999997,Maria Liz Almeida,3,1,2,6,Ocasional
2726,43,5,5524.030000000001,João Albuquerque,3,3,3,9,Regular
2727,37,5,1899.9199999999998,Manuela Aparecida,3,3,1,7,Regular
2728,30,8,6433.1,Calebe Gomes,3,4,3,10,VIP
2729,64,4,3736.66,Manuella Lima,2,2,2,6,Ocasional
2730,147,3,1875.4499999999998,Antônio Borges,1,1,1,3,Inativo
2731,12,4,8144.83,Pietro Barros,4,2,4,10,VIP
2732,42,2,1336.72,Sra. Stephany Pastor,3,1,1,5,Ocasional
2733,7,2,2264.13,José Pedro Marques,4,1,1,6,Ocasional
2734,4,6,9529.25,Nicolas Melo,4,3,4,11,VIP
2735,39,4,2768.59,Alexia Novais,3,2,2,7,Regular
2737,33,5,4422.91,Eduardo da Cruz,3,3,3,9,Regular
2738,106,4,1033.08,Raquel Jesus,1,2,1,4,Ocasional
2739,35,4,1298.83,Juliana Siqueira,3,2,1,6,Ocasional
2740,282,1,19.32,Bruno Mendes,1,1,1,3,Inativo
2741,77,7,9289.0,Vitor Gabriel Santos,2,4,4,10,VIP
2742,69,4,4297.35,Maria Isis Rodrigues,2,2,2,6,Ocasional
2743,15,5,6011.84,Sabrina Lima,4,3,3,10,VIP
2744,108,3,3083.8500000000004,Maya das Neves,1,1,2,4,Ocasional
2745,10,6,7636.78,Luiz Fernando Sousa,4,3,4,11,VIP
2746,10,4,9101.26,Dr. Eduardo Cavalcanti,4,2,4,10,VIP
2747,28,2,3371.2599999999998,Rhavi Garcia,3,1,2,6,Ocasional
2748,117,7,20794.09,Ana Beatriz da Mota,1,4,4,9,Regular
2749,25,5,4391.33,Sr. Pedro Lucas Souza,3,3,3,9,Regular
2750,38,5,7658.37,Dr. João Gabriel Leão,3,3,4,10,VIP
2751,12,4,5129.54,Raquel da Mata,4,2,3,9,Regular
2752,2,6,12606.34,Miguel Sampaio,4,3,4,11,VIP
2753,25,3,1586.87,Dr. Pedro Miguel Sousa,3,1,1,5,Ocasional
2754,166,2,8052.58,Dr. Henrique Novais,1,1,4,6,Ocasional
2755,42,5,9887.83,Matheus Cirino,3,3,4,10,VIP
2756,44,3,6735.52,Miguel Abreu,2,1,3,6,Ocasional
2757,42,6,4407.29,Beatriz Pereira,3,3,3,9,Regular
2758,7,8,10104.94,Kaique Brito,4,4,4,12,VIP
2759,21,10,5471.82,Vicente Teixeira,3,4,3,10,VIP
2760,15,7,5912.18,Maya Ferreira,4,4,3,11,VIP
2761,153,3,4716.95,João Rezende,1,1,3,5,Ocasional
2762,17,5,9649.29,Emanuella Casa Grande,4,3,4,11,VIP
2763,160,3,995.03,Srta. Letícia Camargo,1,1,1,3,Inativo
2764,6,5,6907.47,Lucas Gabriel Ramos,4,3,3,10,VIP
2765,75,3,1561.53,Vitor Gabriel Mendes,2,1,1,4,Ocasional
2766,12,5,1310.2,Luigi da Mata,4,3,1,8,Regular
2767,138,4,2302.23,Luara Cassiano,1,2,2,5,Ocasional
2768,106,3,1643.13,Manuella Mendonça,1,1,1,3,Inativo
2769,39,7,15456.419999999998,Julia Pires,3,4,4,11,VIP
2770,105,1,3812.62,Liz Macedo,1,1,2,4,Ocasional
2771,80,5,4287.09,Aylla da Cunha,2,3,2,7,Regular
2772,82,6,2387.73,Sra. Manuela Aparecida,2,3,2,7,Regular
2773,70,7,4506.81,Maria Julia Brito,2,4,3,9,Regular
2774,206,1,1069.65,Ana Carolina Gomes,1,1,1,3,Inativo
2775,25,5,3359.93,Dra. Emanuelly Moura,3,3,2,8,Regular
2776,90,4,5751.84,Isabela Rios,1,2,3,6,Ocasional
2777,200,2,3279.58,Isabella Freitas,1,1,2,4,Ocasional
2778,106,2,3662.1400000000003,Hadassa da Mata,1,1,2,4,Ocasional
2779,40,3,6728.139999999999,João Gabriel Correia,3,1,3,7,Regular
2780,45,4,9965.4,Heloísa Lopes,2,2,4,8,Regular
2781,19,6,3305.9500000000003,Ana Luiza Sales,4,3,2,9,Regular
2782,51,2,641.3299999999999,Heloísa Fonseca,2,1,1,4,Ocasional
2783,3,5,5928.91,Sr. Oliver da Costa,4,3,3,10,VIP
2784,11,6,11360.84,Maria Julia Lima,4,3,4,11,VIP
2785,63,5,3790.5,João Pires,2,3,2,7,Regular
2786,22,8,7235.59,Ísis Nunes,3,4,3,10,VIP
2787,323,1,605.28,Júlia Garcia,1,1,1,3,Inativo
2788,102,3,3706.69,Vitor Rios,1,1,2,4,Ocasional
2789,85,8,10560.23,Benjamin Costela,2,4,4,10,VIP
2790,47,2,746.15,Theo Barros,2,1,1,4,Ocasional
2791,49,4,5172.32,Joaquim Duarte,2,2,3,7,Regular
2792,138,6,7764.73,Gael Henrique Abreu,1,3,4,8,Regular
2793,76,6,9716.84,Rafaela Lopes,2,3,4,9,Regular
2794,20,5,6680.2699999999995,Rafaela Sales,3,3,3,9,Regular
2795,20,6,5348.61,Valentina Moreira,3,3,3,9,Regular
2796,135,4,12834.330000000002,Augusto Câmara,1,2,4,7,Regular
2797,38,4,3025.2799999999997,Letícia Caldeira,3,2,2,7,Regular
2798,46,7,9564.66,Arthur Gabriel Nunes,2,4,4,10,VIP
2799,34,4,2400.73,Rael Rodrigues,3,2,2,7,Regular
2800,40,2,648.62,Cecília Pacheco,3,1,1,5,Ocasional
2801,23,6,8175.8,Josué Porto,3,3,4,10,VIP
2802,102,2,1177.34,Daniel Lima,1,1,1,3,Inativo
2803,37,3,1041.0300000000002,Isabel Costa,3,1,1,5,Ocasional
2804,2,4,3764.22,André Jesus,4,2,2,8,Regular
2805,55,3,5450.78,Luiz Felipe Campos,2,1,3,6,Ocasional
2806,41,4,2419.31,Isabelly Correia,3,2,2,7,Regular
2807,25,4,3737.12,Dr. Carlos Eduardo Monteiro,3,2,2,7,Regular
2808,28,5,10764.43,Milena Araújo,3,3,4,10,VIP
2809,105,4,1645.77,Vitor Hugo da Conceição,1,2,1,4,Ocasional
2810,103,3,5363.53,Natália Martins,1,1,3,5,Ocasional
2811,261,1,1628.05,Mirella Rocha,1,1,1,3,Inativo
2812,2,1,126.32,Otto Souza,4,1,1,6,Ocasional
2813,232,1,675.86,Lara Nascimento,1,1,1,3,Inativo
2814,6,8,3267.33,Luiz Felipe Gomes,4,4,2,10,VIP
2815,29,6,6476.86,Maria Cecília Pacheco,3,3,3,9,Regular
2816,51,3,2329.22,Olívia Gonçalves,2,1,2,5,Ocasional
2817,94,5,5252.34,Mirella Cassiano,1,3,3,7,Regular
2819,65,3,3060.38,Sra. Alexia Lopes,2,1,2,5,Ocasional
2820,138,5,4302.27,Henrique Moreira,1,3,2,6,Ocasional
2821,12,6,17890.89,Mirella Macedo,4,3,4,11,VIP
2822,23,6,4074.25,Ester Souza,3,3,2,8,Regular
2823,189,1,354.56,Sr. Davi Lucca Novaes,1,1,1,3,Inativo
2824,129,3,1705.87,Eloah da Paz,1,1,1,3,Inativo
2825,33,6,5884.43,Heloísa da Cunha,3,3,3,9,Regular
2826,25,4,2615.24,Ian Rodrigues,3,2,2,7,Regular
2827,32,11,7834.5,Luna Vasconcelos,3,4,4,11,VIP
2828,53,2,191.60000000000002,Mateus da Luz,2,1,1,4,Ocasional
2829,34,2,617.9100000000001,Stephany Viana,3,1,1,5,Ocasional
2830,6,4,11116.84,Sr. Pedro Miguel Jesus,4,2,4,10,VIP
2831,13,6,3189.94,Ísis Gonçalves,4,3,2,9,Regular
2832,48,8,10121.37,Davi da Cruz,2,4,4,10,VIP
2833,1,4,1900.6799999999998,Caroline Nogueira,4,2,1,7,Regular
2834,83,3,329.03,Srta. Isis Castro,2,1,1,4,Ocasional
2835,61,4,3759.23,Kaique Camargo,2,2,2,6,Ocasional
2836,14,5,8942.98,Alana Almeida,4,3,4,11,VIP
2837,48,5,2373.83,Diogo Rodrigues,2,3,2,7,Regular
2838,9,4,2072.08,Miguel da Mota,4,2,1,7,Regular
2839,5,6,7211.71,Ravi Lucca Dias,4,3,3,10,VIP
2840,15,6,9500.18,Isis da Mota,4,3,4,11,VIP
2841,83,3,1034.24,Dr. Vitor Hugo Correia,2,1,1,4,Ocasional
2842,238,1,150.7,Yasmin Santos,1,1,1,3,Inativo
2843,78,4,9032.06,Murilo Mendonça,2,2,4,8,Regular
2844,124,3,11469.69,Luiz Otávio Aparecida,1,1,4,6,Ocasional
2845,53,4,6437.84,Sr. Davi Lucca Aparecida,2,2,3,7,Regular
2846,93,4,3872.97,Milena Abreu,1,2,2,5,Ocasional
2847,65,5,3499.05,Maria Fernanda Duarte,2,3,2,7,Regular
2848,171,2,1687.26,Ravi Lucca Farias,1,1,1,3,Inativo
2849,16,8,16411.79,Noah Castro,4,4,4,12,VIP
2850,6,5,17316.11,Felipe da Rosa,4,3,4,11,VIP
2851,79,2,1430.33,Kaique Correia,2,1,1,4,Ocasional
2852,97,2,1922.19,Maria Cecília Melo,1,1,1,3,Inativo
2853,16,4,6487.48,Benicio Teixeira,4,2,3,9,Regular
2854,151,5,3758.61,Mariah Aragão,1,3,2,6,Ocasional
2855,53,5,2439.81,Heloísa Mendes,2,3,2,7,Regular
2856,6,6,10835.84,Daniela Andrade,4,3,4,11,VIP
2857,61,6,7187.110000000001,Sra. Ana Liz Brito,2,3,3,8,Regular
2858,14,2,5397.42,Miguel das Neves,4,1,3,8,Regular
2859,1,6,3609.42,Juliana Cardoso,4,3,2,9,Regular
2860,22,9,3856.0699999999997,Isabelly Vieira,3,4,2,9,Regular
2861,134,2,1120.85,Enzo Gabriel Cavalcante,1,1,1,3,Inativo
2862,51,3,5121.32,Guilherme Casa Grande,2,1,3,6,Ocasional
2863,8,6,11758.98,Ana Lívia Ramos,4,3,4,11,VIP
2864,65,4,5101.53,Benjamim Silva,2,2,3,7,Regular
2865,85,3,6889.959999999999,Pedro Macedo,2,1,3,6,Ocasional
2866,32,9,7357.8099999999995,Allana da Mota,3,4,4,11,VIP
2867,56,5,4848.87,Lucas Gabriel Marques,2,3,3,8,Regular
2868,158,2,1372.05,João Guilherme Fernandes,1,1,1,3,Inativo
2869,178,5,5498.33,Eduardo da Rocha,1,3,3,7,Regular
2870,188,6,18774.29,Luiz Felipe Aparecida,1,3,4,8,Regular
2871,250,1,228.71,Ryan Santos,1,1,1,3,Inativo
2872,17,2,2444.16,Srta. Júlia Cassiano,4,1,2,7,Regular
2875,6,7,8641.119999999999,Lucas Gabriel Sales,4,4,4,12,VIP
2876,24,8,14341.89,Théo Pires,3,4,4,11,VIP
2877,4,3,4462.87,Catarina Barbosa,4,1,3,8,Regular
2878,40,8,3252.01,Levi Aparecida,3,4,2,9,Regular
2879,31,3,2141.92,Melissa Marques,3,1,1,5,Ocasional
2880,4,4,5216.78,Ana Cecília Souza,4,2,3,9,Regular
2881,42,3,4064.1499999999996,Henrique Peixoto,3,1,2,6,Ocasional
2882,133,2,1406.19,Matteo Ribeiro,1,1,1,3,Inativo
2883,90,8,4813.650000000001,Maria Borges,1,4,3,8,Regular
2884,15,3,1202.83,Zoe Teixeira,4,1,1,6,Ocasional
2885,8,5,8270.33,Sra. Eduarda Abreu,4,3,4,11,VIP
2886,180,6,5998.65,Dr. João Miguel Almeida,1,3,3,7,Regular
2887,7,4,1574.45,Melina Moreira,4,2,1,7,Regular
2888,45,4,4552.56,Mathias Mendes,2,2,3,7,Regular
2889,162,1,712.06,Dr. Carlos Eduardo Barros,1,1,1,3,Inativo
2890,120,3,2493.3999999999996,Dr. Gustavo Henrique da Rosa,1,1,2,4,Ocasional
2892,3,6,2512.21,Guilherme Brito,4,3,2,9,Regular
2893,130,3,4879.42,Bianca Freitas,1,1,3,5,Ocasional
2894,3,3,2607.7,Marcelo da Rocha,4,1,2,7,Regular
2895,16,3,2574.7599999999998,Srta. Giovanna Nunes,4,1,2,7,Regular
2896,38,6,5239.839999999999,Marcos Vinicius Brito,3,3,3,9,Regular
2897,82,6,6066.8,Arthur Alves,2,3,3,8,Regular
2898,22,12,10193.08,Antony Mendonça,3,4,4,11,VIP
2899,37,5,3280.59,Théo Pinto,3,3,2,8,Regular
2900,165,1,42.51,Diogo Fernandes,1,1,1,3,Inativo
2901,97,2,2572.79,Davi Lucca Câmara,1,1,2,4,Ocasional
2902,1,4,1694.89,Maria Eduarda Moreira,4,2,1,7,Regular
2903,10,4,2169.58,Lucca Azevedo,4,2,1,7,Regular
2904,4,2,2570.3,Valentina Novaes,4,1,2,7,Regular
2905,256,2,4899.85,Maria Júlia Pimenta,1,1,3,5,Ocasional
2906,54,9,12430.41,Dom da Cunha,2,4,4,10,VIP
2907,84,2,520.22,Luiz Otávio Aparecida,2,1,1,4,Ocasional
2908,38,7,4256.09,Camila da Luz,3,4,2,9,Regular
2909,108,4,3797.48,Ayla Montenegro,1,2,2,5,Ocasional
2910,89,5,7134.83,Hadassa da Rocha,1,3,3,7,Regular
2911,93,3,5095.96,Valentim Caldeira,1,1,3,5,Ocasional
2912,3,7,11613.61,Emanuel Dias,4,4,4,12,VIP
2913,110,4,1982.73,João Guilherme Vieira,1,2,1,4,Ocasional
2914,100,4,4254.22,Antônio Costa,1,2,2,5,Ocasional
2915,19,8,13054.08,Raul Duarte,4,4,4,12,VIP
2916,52,2,3179.65,Julia da Luz,2,1,2,5,Ocasional
2917,30,6,5843.32,Laura Borges,3,3,3,9,Regular
2918,5,5,4104.77,Milena Ferreira,4,3,2,9,Regular
2919,43,4,2740.58,Isabella Borges,3,2,2,7,Regular
2920,20,3,5051.9,Enzo Duarte,3,1,3,7,Regular
2921,74,5,13979.630000000001,Maria Liz Martins,2,3,4,9,Regular
2922,26,5,3377.2599999999998,Josué Guerra,3,3,2,8,Regular
2923,181,3,680.79,Rodrigo Dias,1,1,1,3,Inativo
2924,28,3,3550.4700000000003,Mariana Aragão,3,1,2,6,Ocasional
2925,30,4,4415.29,Dr. Otávio Machado,3,2,3,8,Regular
2926,28,2,7168.66,Sra. Maria Fernanda Castro,3,1,3,7,Regular
2927,49,3,3951.6,Alexandre Sá,2,1,2,5,Ocasional
2928,90,4,6903.669999999999,Rhavi Ramos,1,2,3,6,Ocasional
2929,43,10,7416.98,Srta. Júlia Montenegro,3,4,4,11,VIP
2930,26,3,2769.05,Dr. Lucas Ribeiro,3,1,2,6,Ocasional
2931,245,2,945.48,Srta. Isabella da Mota,1,1,1,3,Inativo
2932,8,3,1415.58,Sr. Rhavi da Conceição,4,1,1,6,Ocasional
2933,80,3,3688.77,Esther Freitas,2,1,2,5,Ocasional
2934,155,2,1039.07,Lunna Fonseca,1,1,1,3,Inativo
2935,80,4,1132.03,Srta. Ágatha Gonçalves,2,2,1,5,Ocasional
2936,132,5,7217.0599999999995,Ana Laura Farias,1,3,3,7,Regular
2937,50,4,5232.42,Benjamin Barros,2,2,3,7,Regular
2938,188,5,4501.8,Dra. Sophie Barros,1,3,3,7,Regular
2939,25,4,8862.46,Gael Moura,3,2,4,9,Regular
2940,38,1,27.95,Brayan Araújo,3,1,1,5,Ocasional
2941,48,5,6990.12,Dr. Otto Azevedo,2,3,3,8,Regular
2942,117,1,17.9,Vinicius Siqueira,1,1,1,3,Inativo
2943,121,2,4078.1099999999997,Noah da Luz,1,1,2,4,Ocasional
2944,10,4,1618.78,Ana Luiza Jesus,4,2,1,7,Regular
2945,23,4,6076.860000000001,Ana Lívia Silva,3,2,3,8,Regular
2946,23,6,4202.23,Bella Cavalcanti,3,3,2,8,Regular
2947,177,2,635.46,Francisco Dias,1,1,1,3,Inativo
2948,28,8,6352.26,Paulo Vargas,3,4,3,10,VIP
2949,73,4,6447.12,Augusto Lima,2,2,3,7,Regular
2950,216,3,5661.07,Dr. Luiz Fernando Peixoto,1,1,3,5,Ocasional
2951,15,5,6016.83,Ana Júlia Cavalcante,4,3,3,10,VIP
2952,17,4,5930.44,Emanuelly Silveira,4,2,3,9,Regular
2953,184,2,352.56,Brayan Nascimento,1,1,1,3,Inativo
2954,29,5,5368.25,Fernanda Pereira,3,3,3,9,Regular
2955,31,4,1881.16,Rael da Mata,3,2,1,6,Ocasional
2956,40,4,4228.75,Dra. Mariana Casa Grande,3,2,2,7,Regular
2957,42,5,4910.55,Enrico Costela,3,3,3,9,Regular
2958,84,4,5755.66,Thomas Sampaio,2,2,3,7,Regular
2959,24,2,3309.87,Daniel Aparecida,3,1,2,6,Ocasional
2960,77,3,2286.13,Paulo Fogaça,2,1,2,5,Ocasional
2961,40,5,9000.43,Melissa Almeida,3,3,4,10,VIP
2962,8,2,6713.51,Marina Teixeira,4,1,3,8,Regular
2963,74,2,960.0300000000001,Dr. Caleb Rodrigues,2,1,1,4,Ocasional
2964,225,2,1424.0100000000002,Dra. Jade Santos,1,1,1,3,Inativo
2965,33,6,8359.27,Alexia Machado,3,3,4,10,VIP
2966,234,2,5124.52,Alexandre Santos,1,1,3,5,Ocasional
2967,143,1,380.06,Bruna Lopes,1,1,1,3,Inativo
2968,38,4,6035.47,Maria Isis Novais,3,2,3,8,Regular
2969,265,2,1676.1299999999999,Marcelo da Mota,1,1,1,3,Inativo
2970,20,6,8936.09,Yago da Paz,3,3,4,10,VIP
2971,9,6,5560.74,Noah Sales,4,3,3,10,VIP
2972,111,8,5262.78,Liam Almeida,1,4,3,8,Regular
2973,59,2,169.93,Lucas Freitas,2,1,1,4,Ocasional
2974,37,2,2432.54,Luan Montenegro,3,1,2,6,Ocasional
2975,231,1,763.49,Dra. Lorena Monteiro,1,1,1,3,Inativo
2976,6,4,2878.16,Caio Camargo,4,2,2,8,Regular
2977,73,5,14907.73,Zoe Cavalcanti,2,3,4,9,Regular
2978,77,8,11319.71,Antônio da Cunha,2,4,4,10,VIP
2979,46,4,2583.23,Davi Lucca Cavalcanti,2,2,2,6,Ocasional
2980,202,5,4908.76,Luan Sousa,1,3,3,7,Regular
2981,18,7,2791.82,Pietro Pastor,4,4,2,10,VIP
2982,21,4,4158.84,Luan Vargas,3,2,2,7,Regular
2983,121,3,6549.95,Cauê Ferreira,1,1,3,5,Ocasional
2984,50,3,1033.92,Ana Liz Abreu,2,1,1,4,Ocasional
2985,52,5,7261.91,Stella Pastor,2,3,3,8,Regular
2986,36,7,2148.17,Rhavi Oliveira,3,4,1,8,Regular
2987,16,8,3499.69,Heitor Moreira,4,4,2,10,VIP
2988,140,7,13424.42,Sophie Gonçalves,1,4,4,9,Regular
2989,27,6,4248.21,Alexia Ramos,3,3,2,8,Regular
2990,48,7,6945.72,Dra. Letícia Viana,2,4,3,9,Regular
2991,10,4,9683.55,Paulo Carvalho,4,2,4,10,VIP
2992,38,7,4998.74,Sr. Matteo Alves,3,4,3,10,VIP
2993,71,7,3624.0099999999998,Ana Júlia Martins,2,4,2,8,Regular
2994,13,5,6950.4,Luísa Leão,4,3,3,10,VIP
2995,13,5,2093.19,Srta. Ana Laura Macedo,4,3,1,8,Regular
2996,121,3,6026.949999999999,Agatha Mendonça,1,1,3,5,Ocasional
2997,31,5,6243.18,Luna da Paz,3,3,3,9,Regular
2998,23,5,6451.459999999999,Francisco Câmara,3,3,3,9,Regular
2999,177,4,6625.17,Dr. Dante da Paz,1,2,3,6,Ocasional
3000,69,4,3068.52,João Felipe Mendes,2,2,2,6,Ocasional
3001,17,4,11210.75,Dr. Luiz Felipe Sales,4,2,4,10,VIP
3002,3,3,1432.06,Gael Leão,4,1,1,6,Ocasional
3003,92,3,4309.82,Isadora Ribeiro,1,1,2,4,Ocasional
3004,193,1,1681.76,Sra. Bella Cassiano,1,1,1,3,Inativo
3005,5,5,6370.969999999999,Dr. Juan da Paz,4,3,3,10,VIP
3006,4,4,8654.32,Dr. Lorenzo Fernandes,4,2,4,10,VIP
3007,58,4,1152.87,Luana Vieira,2,2,1,5,Ocasional
3008,15,5,13218.08,João Rocha,4,3,4,11,VIP
3009,31,2,1169.38,Maria Flor Silveira,3,1,1,5,Ocasional
3010,18,3,6741.460000000001,Melina Freitas,4,1,3,8,Regular
3011,179,3,3068.52,Amanda Silveira,1,1,2,4,Ocasional
3012,53,4,4603.83,José das Neves,2,2,3,7,Regular
3013,75,3,8103.48,Yuri Rezende,2,1,4,7,Regular
3014,81,5,9273.25,Emanuel Oliveira,2,3,4,9,Regular
3015,64,2,5141.599999999999,Apollo Mendes,2,1,3,6,Ocasional
3016,42,4,7115.49,Thomas da Conceição,3,2,3,8,Regular
3017,10,3,3590.49,Lorenzo Mendonça,4,1,2,7,Regular
3018,175,1,25.64,Valentim Sales,1,1,1,3,Inativo
3019,35,7,9946.56,Maria Clara Montenegro,3,4,4,11,VIP
3020,27,3,4326.7699999999995,Paulo da Luz,3,1,2,6,Ocasional
3021,11,4,9005.58,Nina Sales,4,2,4,10,VIP
3022,119,1,319.34,Dra. Júlia Leão,1,1,1,3,Inativo
3023,20,5,2783.84,Mirella Cassiano,3,3,2,8,Regular
3024,19,4,4780.87,Ana Sophia Santos,4,2,3,9,Regular
3025,36,2,579.5699999999999,Ana Vitória Ramos,3,1,1,5,Ocasional
3026,157,5,9554.18,Murilo Garcia,1,3,4,8,Regular
3027,21,2,1047.98,Davi Cavalcanti,3,1,1,5,Ocasional
3028,200,8,5619.89,Bryan Oliveira,1,4,3,8,Regular
3029,18,5,6639.78,Srta. Olivia Abreu,4,3,3,10,VIP
3030,43,4,6720.44,Benjamin Melo,3,2,3,8,Regular
3031,35,4,2494.18,Maria Helena Machado,3,2,2,7,Regular
3032,21,6,5912.11,Agatha Aragão,3,3,3,9,Regular
3033,92,3,4452.35,Luiz Fernando Rios,1,1,3,5,Ocasional
3034,153,1,4403.23,Emanuella Pinto,1,1,3,5,Ocasional
3035,51,3,4652.29,Lívia Porto,2,1,3,6,Ocasional
3036,235,1,115.0,Luiz Felipe Cassiano,1,1,1,3,Inativo
3037,55,6,12444.61,Larissa Camargo,2,3,4,9,Regular
3038,224,2,3758.9300000000003,Heloísa Macedo,1,1,2,4,Ocasional
3039,96,3,2563.44,Alana Moura,1,1,2,4,Ocasional
3040,26,7,8079.84,Matteo Moreira,3,4,4,11,VIP
3041,140,3,799.62,Dr. Enzo Gabriel da Paz,1,1,1,3,Inativo
3042,18,5,4275.92,Maya Costela,4,3,2,9,Regular
3043,2,6,8017.33,Danilo Borges,4,3,4,11,VIP
3044,6,5,12204.91,Sophia Pimenta,4,3,4,11,VIP
3045,159,3,7103.27,Benjamim Ribeiro,1,1,3,5,Ocasional
3046,34,1,60.9,Eduardo Casa Grande,3,1,1,5,Ocasional
3047,19,8,16604.27,Dr. Yago Castro,4,4,4,12,VIP
3048,78,3,1396.4299999999998,Jade Pereira,2,1,1,4,Ocasional
3049,13,5,2866.98,Rodrigo Silveira,4,3,2,9,Regular
3050,121,2,2441.63,Ana Julia da Mata,1,1,2,4,Ocasional
3051,39,2,1841.2800000000002,Mirella Pastor,3,1,1,5,Ocasional
3052,15,10,11309.3,Bernardo da Costa,4,4,4,12,VIP
3053,31,7,6727.79,Maya Cirino,3,4,3,10,VIP
3054,119,8,13160.38,Amanda Camargo,1,4,4,9,Regular
3055,9,4,3635.74,Marcela Jesus,4,2,2,8,Regular
3056,27,8,5304.31,Ravi Lucca Alves,3,4,3,10,VIP
3057,22,4,1534.19,Davi Lucca Santos,3,2,1,6,Ocasional
3058,46,3,3484.5699999999997,Emanuelly Rezende,2,1,2,5,Ocasional
3059,13,3,5096.91,Dr. Gabriel Azevedo,4,1,3,8,Regular
3060,65,5,5840.69,Raquel Nogueira,2,3,3,8,Regular
3061,13,6,12701.79,Luísa Moraes,4,3,4,11,VIP
3062,14,3,750.97,Enzo Pires,4,1,1,6,Ocasional
3063,88,5,7380.06,Marina Pacheco,1,3,4,8,Regular
3064,47,1,94.14,Dra. Laura Machado,2,1,1,4,Ocasional
3065,267,2,2557.8199999999997,Eloah Pimenta,1,1,2,4,Ocasional
3066,5,7,22080.08,Gustavo Henrique Lopes,4,4,4,12,VIP
3067,9,10,19840.2,Sra. Ísis Gomes,4,4,4,12,VIP
3068,117,2,2085.9700000000003,Sra. Ana Silveira,1,1,1,3,Inativo
3069,8,3,1342.4,Anna Liz Souza,4,1,1,6,Ocasional
3070,183,3,3063.43,Dr. Rhavi da Cruz,1,1,2,4,Ocasional
3071,44,6,1953.56,Benjamin da Cunha,2,3,1,6,Ocasional
3072,29,2,1653.6399999999999,Davi Lucas Cavalcante,3,1,1,5,Ocasional
3073,28,5,4718.29,Srta. Luísa Fernandes,3,3,3,9,Regular
3074,86,4,4012.72,Ana Carolina da Rocha,2,2,2,6,Ocasional
3075,103,4,878.5,Laura Guerra,1,2,1,4,Ocasional
3076,75,8,12206.91,Théo Rios,2,4,4,10,VIP
3077,24,4,7630.81,Enrico da Paz,3,2,4,9,Regular
3078,1,5,3318.98,Isaque Rocha,4,3,2,9,Regular
3079,153,3,7242.97,Amanda Porto,1,1,3,5,Ocasional
3080,152,6,7316.76,Dante da Costa,1,3,3,7,Regular
3081,123,2,2178.8,Ana Júlia Duarte,1,1,1,3,Inativo
3082,9,5,7519.67,Raul da Mota,4,3,4,11,VIP
3083,67,4,2685.2,Eloah Moraes,2,2,2,6,Ocasional
3084,37,6,3232.98,Laís Fogaça,3,3,2,8,Regular
3085,24,7,11683.58,Isabella Sales,3,4,4,11,VIP
3086,51,8,9827.26,Dr. Breno Novais,2,4,4,10,VIP
3088,5,6,7117.25,Caleb da Rosa,4,3,3,10,VIP
3089,107,3,7544.6,Catarina Melo,1,1,4,6,Ocasional
3090,183,4,4167.07,Cecília da Rosa,1,2,2,5,Ocasional
3091,2,6,4117.09,João Miguel da Paz,4,3,2,9,Regular
3092,86,3,1253.38,Alícia Oliveira,2,1,1,4,Ocasional
3094,56,2,810.4699999999999,Eduardo Duarte,2,1,1,4,Ocasional
3095,124,3,749.09,Igor da Luz,1,1,1,3,Inativo
3096,35,4,1141.1399999999999,Aurora Cirino,3,2,1,6,Ocasional
3097,15,2,3216.8500000000004,Caio Sampaio,4,1,2,7,Regular
3098,26,5,1516.3899999999999,Arthur Gabriel Castro,3,3,1,7,Regular
3099,47,8,6113.83,Luiz Miguel Castro,2,4,3,9,Regular
3100,33,3,243.33,Gael Duarte,3,1,1,5,Ocasional
3101,10,5,4718.62,Pedro Pires,4,3,3,10,VIP
3102,17,6,3947.58,Helena Sales,4,3,2,9,Regular
3103,87,3,3668.24,Daniel da Costa,2,1,2,5,Ocasional
3104,7,4,730.26,Ana Vitória da Cunha,4,2,1,7,Regular
3105,30,3,6771.26,Srta. Maria Alice Santos,3,1,3,7,Regular
3106,189,4,8768.76,Theo Ramos,1,2,4,7,Regular
3107,2,4,1940.07,Maria Helena Vargas,4,2,1,7,Regular
3108,27,5,6401.21,Nathan Peixoto,3,3,3,9,Regular
3109,154,2,1068.6399999999999,Henrique Sales,1,1,1,3,Inativo
3110,71,7,10065.4,Apollo Pacheco,2,4,4,10,VIP
3111,32,5,7055.55,Henrique da Rosa,3,3,3,9,Regular
3112,5,8,6961.51,Dra. Valentina Novaes,4,4,3,11,VIP
3113,202,2,7421.49,Diego Moura,1,1,4,6,Ocasional
3114,92,6,7742.33,Heitor Pinto,1,3,4,8,Regular
3115,23,2,1644.63,Paulo Monteiro,3,1,1,5,Ocasional
3116,47,6,9895.32,Diogo da Costa,2,3,4,9,Regular
3117,8,5,10338.19,Luana Jesus,4,3,4,11,VIP
3118,149,4,4048.81,Aurora Cardoso,1,2,2,5,Ocasional
3120,56,3,5204.83,José Barros,2,1,3,6,Ocasional
3121,35,4,10725.44,Brayan Leão,3,2,4,9,Regular
3122,194,4,4633.5,Eloah Guerra,1,2,3,6,Ocasional
3123,140,3,895.76,Erick Sousa,1,1,1,3,Inativo
3124,8,6,8652.76,Apollo Costa,4,3,4,11,VIP
3125,12,4,2588.5,Igor Abreu,4,2,2,8,Regular
3126,27,3,1081.74,Vicente Garcia,3,1,1,5,Ocasional
3127,10,6,9602.01,Giovanna Gomes,4,3,4,11,VIP
3128,334,3,3688.18,Milena Almeida,1,1,2,4,Ocasional
3129,191,6,2703.1499999999996,Sr. Yago Camargo,1,3,2,6,Ocasional
3130,49,4,5929.1,Isis Novais,2,2,3,7,Regular
3131,40,2,904.4300000000001,Luísa Silva,3,1,1,5,Ocasional
3132,42,3,9342.98,Luísa da Rocha,3,1,4,8,Regular
3133,1,6,7539.71,Renan Fernandes,4,3,4,11,VIP
3134,32,4,5992.700000000001,Srta. Melissa Costela,3,2,3,8,Regular
3136,4,4,274.68,Augusto Aragão,4,2,1,7,Regular
3137,47,4,3486.05,Lucca Machado,2,2,2,6,Ocasional
3138,49,2,1653.42,Liz Novais,2,1,1,4,Ocasional
3139,9,8,6923.6900000000005,Vitor Hugo Costa,4,4,3,11,VIP
3140,15,6,10308.439999999999,Camila Ribeiro,4,3,4,11,VIP
3141,67,4,8197.7,Sra. Aylla Barros,2,2,4,8,Regular
3142,102,2,8127.33,Stephany Vieira,1,1,4,6,Ocasional
3143,107,3,4524.85,Murilo da Cunha,1,1,3,5,Ocasional
3144,2,9,2798.77,Dr. Erick Siqueira,4,4,2,10,VIP
3145,74,4,1735.3600000000001,Dra. Rafaela da Rocha,2,2,1,5,Ocasional
3146,57,7,8669.86,Sr. Erick Farias,2,4,4,10,VIP
3147,139,3,983.8199999999999,Rafaela Oliveira,1,1,1,3,Inativo
3148,38,6,19999.39,Sr. Yan Cunha,3,3,4,10,VIP
3149,3,9,8876.52,Srta. Alice Correia,4,4,4,12,VIP
3150,70,2,3207.3599999999997,Stephany Vasconcelos,2,1,2,5,Ocasional
3151,46,5,3615.36,Heloisa Cavalcante,2,3,2,7,Regular
3152,42,3,8351.73,Pedro Henrique Mendonça,3,1,4,8,Regular
3153,89,4,2495.45,Laura Rocha,1,2,2,5,Ocasional
3154,61,3,1920.49,Kamilly Borges,2,1,1,4,Ocasional
3155,5,6,6442.790000000001,Gael das Neves,4,3,3,10,VIP
3156,33,4,4886.1900000000005,Benjamin Cunha,3,2,3,8,Regular
3157,10,6,6930.14,Arthur Gabriel Martins,4,3,3,10,VIP
3158,75,3,480.0,Clarice da Mata,2,1,1,4,Ocasional
3159,59,3,1471.09,Rodrigo Teixeira,2,1,1,4,Ocasional
3160,90,2,223.86,Davi Luiz Monteiro,1,1,1,3,Inativo
3161,16,6,11293.07,Sra. Eduarda Vargas,4,3,4,11,VIP
3162,12,3,2433.98,Giovanna Caldeira,4,1,2,7,Regular
3163,60,4,2650.9500000000003,André Nogueira,2,2,2,6,Ocasional
3164,24,7,8711.800000000001,Gabriel da Conceição,3,4,4,11,VIP
3165,92,5,7939.960000000001,Antonella Cardoso,1,3,4,8,Regular
3166,40,2,2029.23,Dra. Maria Fernanda Sá,3,1,1,5,Ocasional
3167,29,7,3373.8900000000003,Léo Santos,3,4,2,9,Regular
3168,18,7,4460.110000000001,Eduarda Lopes,4,4,3,11,VIP
3169,12,5,4074.0899999999997,Mariane Moreira,4,3,2,9,Regular
3170,297,1,161.1,Rafael Pimenta,1,1,1,3,Inativo
3171,78,6,4957.13,Sr. Isaac Cavalcante,2,3,3,8,Regular
3172,62,3,6647.76,Ana Cardoso,2,1,3,6,Ocasional
3173,133,3,3776.81,Kaique Monteiro,1,1,2,4,Ocasional
3174,35,3,4049.5299999999997,Dra. Aurora Siqueira,3,1,2,6,Ocasional
3175,130,3,4347.08,Eloá Cassiano,1,1,2,4,Ocasional
3176,105,3,4925.04,Maria Vitória da Conceição,1,1,3,5,Ocasional
3177,63,6,3351.31,Sra. Maria Vitória Fonseca,2,3,2,7,Regular
3178,85,2,1053.64,Helena Andrade,2,1,1,4,Ocasional
3179,48,7,7565.67,Mateus Rios,2,4,4,10,VIP
3180,24,7,7032.75,Gabrielly Silveira,3,4,3,10,VIP
3181,17,7,5669.51,Ana Luiza Lima,4,4,3,11,VIP
3182,224,2,1298.1000000000001,Stella Lopes,1,1,1,3,Inativo
3184,39,4,4905.969999999999,Ana Laura Viana,3,2,3,8,Regular
3185,72,4,2646.2000000000003,Dra. Maria Clara Porto,2,2,2,6,Ocasional
3186,18,8,5501.34,Letícia da Cunha,4,4,3,11,VIP
3187,48,3,3420.62,Luan Cardoso,2,1,2,5,Ocasional
3188,138,4,8024.15,Liz Sousa,1,2,4,7,Regular
3189,247,3,798.29,Luiz Gustavo Aparecida,1,1,1,3,Inativo
3190,57,6,9337.03,Sra. Ana Laura Cassiano,2,3,4,9,Regular
3191,181,4,3081.9799999999996,Eloah da Luz,1,2,2,5,Ocasional
3192,30,3,6431.3099999999995,Daniel Cirino,3,1,3,7,Regular
3193,25,3,2519.11,Vicente Nogueira,3,1,2,6,Ocasional
3194,213,1,138.07,Bento Cunha,1,1,1,3,Inativo
3195,27,6,6359.9,Bruno Lima,3,3,3,9,Regular
3196,61,4,8304.130000000001,Maria Luiza Sampaio,2,2,4,8,Regular
3197,32,4,5451.81,Asafe Viana,3,2,3,8,Regular
3198,17,8,6353.9800000000005,Maria Vitória Silva,4,4,3,11,VIP
3199,50,6,3716.76,Lucca Viana,2,3,2,7,Regular
3200,31,5,3629.02,Luiz Gustavo Martins,3,3,2,8,Regular
3202,16,4,3402.5899999999997,Henry Oliveira,4,2,2,8,Regular
3203,47,4,3143.76,Alexia Ramos,2,2,2,6,Ocasional
3204,202,1,3017.12,Maria Clara Almeida,1,1,2,4,Ocasional
3205,71,2,1152.27,Breno Teixeira,2,1,1,4,Ocasional
3206,86,2,355.34999999999997,Asafe Rios,2,1,1,4,Ocasional
3207,45,3,740.92,Marcela Gomes,2,1,1,4,Ocasional
3208,68,4,9835.56,Srta. Maria Vitória Viana,2,2,4,8,Regular
3209,78,3,5448.049999999999,Sr. Paulo Dias,2,1,3,6,Ocasional
3210,41,4,5666.51,Ana Luiza Nogueira,3,2,3,8,Regular
3211,275,3,7772.09,Gael Henrique Araújo,1,1,4,6,Ocasional
3212,101,4,5319.9800000000005,Henry Camargo,1,2,3,6,Ocasional
3213,2,6,4395.52,Bianca Oliveira,4,3,3,10,VIP
3214,80,9,5133.25,Benicio Cunha,2,4,3,9,Regular
3215,21,4,2077.14,Dra. Alice da Cunha,3,2,1,6,Ocasional
3216,55,4,8262.46,José Miguel Andrade,2,2,4,8,Regular
3217,42,9,8135.77,Nathan Albuquerque,3,4,4,11,VIP
3218,13,2,2116.69,Hellena Rodrigues,4,1,1,6,Ocasional
3219,53,5,12500.56,Allana da Rocha,2,3,4,9,Regular
3220,9,3,6499.67,Antonella Peixoto,4,1,3,8,Regular
3221,24,8,14390.29,Camila Melo,3,4,4,11,VIP
3222,57,2,761.91,Caroline Pereira,2,1,1,4,Ocasional
3223,33,5,2550.11,Maya Albuquerque,3,3,2,8,Regular
3224,8,2,2004.51,Maria Sophia Mendes,4,1,1,6,Ocasional
3225,85,9,17221.12,Laís Aparecida,2,4,4,10,VIP
3226,7,3,1204.4900000000002,Lorenzo Casa Grande,4,1,1,6,Ocasional
3227,14,4,4184.05,Luna Souza,4,2,2,8,Regular
3228,79,3,1592.6599999999999,Anthony Pires,2,1,1,4,Ocasional
3229,22,3,1955.69,Dr. Antony Farias,3,1,1,5,Ocasional
3230,180,4,3333.7700000000004,Srta. Alana Pereira,1,2,2,5,Ocasional
3231,160,3,1557.3799999999999,Breno da Mota,1,1,1,3,Inativo
3232,154,3,6908.969999999999,Ravi Lucca Mendes,1,1,3,5,Ocasional
3233,27,8,10555.220000000001,Ian Borges,3,4,4,11,VIP
3234,32,4,7081.960000000001,Matheus Cassiano,3,2,3,8,Regular
3235,22,5,4283.1,Larissa Vasconcelos,3,3,2,8,Regular
3236,51,4,2384.09,Sra. Clarice Dias,2,2,2,6,Ocasional
3237,99,5,4991.01,Valentina Rocha,1,3,3,7,Regular
3239,35,4,2597.34,Ana Clara Nascimento,3,2,2,7,Regular
3240,30,6,5895.3099999999995,Caroline Araújo,3,3,3,9,Regular
3241,281,2,822.51,Esther Caldeira,1,1,1,3,Inativo
3242,71,2,523.4499999999999,José Miguel Vieira,2,1,1,4,Ocasional
3243,193,3,7067.34,Maria Helena das Neves,1,1,3,5,Ocasional
3244,41,8,14226.54,Aylla Campos,3,4,4,11,VIP
3245,12,8,5512.16,Ana Borges,4,4,3,11,VIP
3246,41,3,881.45,Kevin Peixoto,3,1,1,5,Ocasional
3247,21,6,6475.3,Valentina Montenegro,3,3,3,9,Regular
3248,3,5,9450.91,Luiz Otávio Oliveira,4,3,4,11,VIP
3249,74,7,15249.57,Théo Cardoso,2,4,4,10,VIP
3250,151,3,1062.62,Ian Pereira,1,1,1,3,Inativo
3251,23,4,3170.2700000000004,Leonardo Siqueira,3,2,2,7,Regular
3252,187,2,760.56,André Marques,1,1,1,3,Inativo
3253,30,5,1997.3799999999999,Milena Garcia,3,3,1,7,Regular
3254,61,6,2463.28,Carolina Campos,2,3,2,7,Regular
3255,103,2,2332.12,Catarina Lima,1,1,2,4,Ocasional
3256,22,8,10206.51,Marina Nunes,3,4,4,11,VIP
3257,28,5,6440.16,Calebe Cirino,3,3,3,9,Regular
3258,117,4,3865.6899999999996,Caleb Camargo,1,2,2,5,Ocasional
3260,51,2,1053.86,Aylla Barros,2,1,1,4,Ocasional
3261,13,4,4004.19,Dr. Enzo Barbosa,4,2,2,8,Regular
3262,50,5,6483.31,Matteo Fernandes,2,3,3,8,Regular
3263,6,7,4866.24,Sr. Luiz Miguel Viana,4,4,3,11,VIP
3264,60,5,7708.48,Luiz Felipe Câmara,2,3,4,9,Regular
3265,12,6,5637.32,Gael Costa,4,3,3,10,VIP
3266,1,5,4031.15,Bruno Câmara,4,3,2,9,Regular
3267,80,5,5710.21,Noah da Cunha,2,3,3,8,Regular
3268,9,5,8163.18,Dra. Maria Júlia Brito,4,3,4,11,VIP
3269,61,4,6786.900000000001,Aurora Fernandes,2,2,3,7,Regular
3270,297,1,986.75,Maria Helena Martins,1,1,1,3,Inativo
3271,29,8,4269.32,Fernando Teixeira,3,4,2,9,Regular
3272,122,5,3690.58,Maysa Castro,1,3,2,6,Ocasional
3273,63,6,7945.1900000000005,Nina Abreu,2,3,4,9,Regular
3274,80,4,3722.55,Emilly Siqueira,2,2,2,6,Ocasional
3275,170,4,3883.62,Mariah Sá,1,2,2,5,Ocasional
3276,42,8,9628.34,Laís Cunha,3,4,4,11,VIP
3277,13,5,7964.98,Maria Laura Monteiro,4,3,4,11,VIP
3278,199,2,1556.56,Sra. Maria Isis Pinto,1,1,1,3,Inativo
3279,57,10,9149.28,Liam Ramos,2,4,4,10,VIP
3280,27,4,3637.1000000000004,Eloá Peixoto,3,2,2,7,Regular
3281,21,8,18549.39,Sr. Isaac Macedo,3,4,4,11,VIP
3282,209,3,6001.83,Vitor Freitas,1,1,3,5,Ocasional
3283,51,2,920.04,Vinicius Aparecida,2,1,1,4,Ocasional
3284,43,3,3072.71,Luiz Gustavo Abreu,3,1,2,6,Ocasional
3285,68,5,2729.82,Srta. Maria Luísa Fonseca,2,3,2,7,Regular
3286,25,6,8165.25,Lara Ramos,3,3,4,10,VIP
3287,36,4,4808.68,Ryan Costa,3,2,3,8,Regular
3288,9,6,2678.58,Larissa Azevedo,4,3,2,9,Regular
3289,49,4,4682.9400000000005,Luan Camargo,2,2,3,7,Regular
3290,116,8,17081.76,Fernanda da Costa,1,4,4,9,Regular
3291,121,2,3504.9,Dr. Renan Moura,1,1,2,4,Ocasional
3292,4,5,4047.62,Ana Silveira,4,3,2,9,Regular
3293,133,7,6643.18,Ágatha Rodrigues,1,4,3,8,Regular
3294,41,4,9166.63,Samuel Martins,3,2,4,9,Regular
3295,110,3,10724.2,Josué Monteiro,1,1,4,6,Ocasional
3296,4,3,2071.24,Ana Luiza Teixeira,4,1,1,6,Ocasional
3297,41,3,1710.26,Thales Andrade,3,1,1,5,Ocasional
3298,40,6,3295.0600000000004,Anthony da Conceição,3,3,2,8,Regular
3299,120,4,3579.7799999999997,João Pinto,1,2,2,5,Ocasional
3300,122,6,10460.73,Sofia da Cruz,1,3,4,8,Regular
3301,330,1,435.04,Dr. José Pedro da Mata,1,1,1,3,Inativo
3302,340,1,145.01,Ana Beatriz Martins,1,1,1,3,Inativo
3303,56,5,11805.34,Gustavo Rezende,2,3,4,9,Regular
3304,21,5,7928.55,Joaquim Fogaça,3,3,4,10,VIP
3305,1,8,16539.94,Bárbara Fogaça,4,4,4,12,VIP
3306,29,4,2038.71,Maria Alice Cunha,3,2,1,6,Ocasional
3307,124,3,2574.1499999999996,Yasmin Carvalho,1,1,2,4,Ocasional
3309,95,4,4873.95,Dr. Ryan Peixoto,1,2,3,6,Ocasional
3310,149,6,11240.71,Lunna da Costa,1,3,4,8,Regular
3311,84,3,2341.89,Théo Carvalho,2,1,2,5,Ocasional
3312,42,4,10977.240000000002,Dr. Ravi Lucca Rodrigues,3,2,4,9,Regular
3313,7,7,5201.530000000001,Benjamim Moraes,4,4,3,11,VIP
3314,44,11,5752.93,Bella Rocha,2,4,3,9,Regular
3315,14,14,13279.91,Srta. Sophia Oliveira,4,4,4,12,VIP
3316,153,2,6886.21,Maria Cecília Ferreira,1,1,3,5,Ocasional
3317,114,3,413.39,Eduardo Machado,1,1,1,3,Inativo
3318,327,1,614.52,Júlia Freitas,1,1,1,3,Inativo
3319,99,4,3265.23,João Pedro Sousa,1,2,2,5,Ocasional
3321,14,2,433.03000000000003,Pedro Henrique Lima,4,1,1,6,Ocasional
3322,1,6,5027.46,Eduardo Farias,4,3,3,10,VIP
3323,141,5,11398.46,Marcos Vinicius da Rosa,1,3,4,8,Regular
3324,27,4,5206.6,Benício da Paz,3,2,3,8,Regular
3325,11,5,2193.54,Dr. Isaque Vieira,4,3,1,8,Regular
3326,43,5,14935.16,Hadassa Costela,3,3,4,10,VIP
3327,60,5,1761.6399999999999,Sr. Kevin Souza,2,3,1,6,Ocasional
3328,58,9,15184.570000000002,Léo Farias,2,4,4,10,VIP
3329,44,3,1179.19,Isabel Câmara,2,1,1,4,Ocasional
3330,152,2,7101.77,Vinicius Oliveira,1,1,3,5,Ocasional
3331,11,4,1923.7800000000002,Cauê Freitas,4,2,1,7,Regular
3332,11,2,4553.66,Isaac Santos,4,1,3,8,Regular
3333,83,3,3063.0299999999997,Yago Novais,2,1,2,5,Ocasional
3334,13,3,5076.43,Letícia da Paz,4,1,3,8,Regular
3335,43,4,6134.82,Davi Luiz Sousa,3,2,3,8,Regular
3336,6,4,1824.57,Maya da Rocha,4,2,1,7,Regular
3337,18,3,5505.02,Evelyn Vargas,4,1,3,8,Regular
3338,77,3,2151.17,Sr. Yan Melo,2,1,1,4,Ocasional
3339,14,4,5378.450000000001,Aurora das Neves,4,2,3,9,Regular
3340,17,5,13099.62,Maria Luiza das Neves,4,3,4,11,VIP
3341,38,3,375.05,Alexia Novais,3,1,1,5,Ocasional
3342,114,1,77.13,Ana Luiza Campos,1,1,1,3,Inativo
3343,44,7,11167.75,Catarina da Mata,2,4,4,10,VIP
3344,11,8,3383.7000000000003,Ryan Santos,4,4,2,10,VIP
3345,248,1,9564.86,Lunna Monteiro,1,1,4,6,Ocasional
3346,15,6,3935.79,Dr. Murilo Rezende,4,3,2,9,Regular
3347,85,5,3222.0,Srta. Maria Laura Porto,2,3,2,7,Regular
3348,2,9,10073.68,Enzo Martins,4,4,4,12,VIP
3349,296,2,6756.25,Felipe Aparecida,1,1,3,5,Ocasional
3350,3,5,5663.68,Sr. Benicio da Cruz,4,3,3,10,VIP
3351,36,3,5050.65,Sr. Isaac Câmara,3,1,3,7,Regular
3352,357,1,334.24,Francisco Santos,1,1,1,3,Inativo
3353,50,5,8158.37,Dra. Ana Julia Vasconcelos,2,3,4,9,Regular
3354,2,8,7283.110000000001,Dra. Ana Vitória Sousa,4,4,3,11,VIP
3355,44,2,636.0,Luiz Fernando Marques,2,1,1,4,Ocasional
3356,7,5,5934.56,Srta. Marcela Pimenta,4,3,3,10,VIP
3357,23,4,9303.130000000001,Leonardo Abreu,3,2,4,9,Regular
3358,111,2,1039.13,Eduardo Carvalho,1,1,1,3,Inativo
3359,99,2,1452.84,Brenda da Paz,1,1,1,3,Inativo
3360,14,6,3803.1400000000003,Josué Borges,4,3,2,9,Regular
3361,28,5,3734.5299999999997,Aurora Jesus,3,3,2,8,Regular
3363,17,6,13580.24,Luara Camargo,4,3,4,11,VIP
3364,138,3,4007.01,Liam Martins,1,1,2,4,Ocasional
3365,88,2,9641.0,Mirella Sales,1,1,4,6,Ocasional
3366,193,2,4438.139999999999,Srta. Allana Pires,1,1,3,5,Ocasional
3367,23,5,5984.969999999999,Pedro Miguel Pacheco,3,3,3,9,Regular
3368,22,9,12575.61,Julia Jesus,3,4,4,11,VIP
3369,244,4,7636.42,Ana Luiza Duarte,1,2,4,7,Regular
3370,59,5,4664.889999999999,Matteo Vasconcelos,2,3,3,8,Regular
3371,8,4,3906.5700000000006,Dr. Gael Martins,4,2,2,8,Regular
3372,55,4,4602.53,Rael Machado,2,2,3,7,Regular
3373,127,3,7684.35,Francisco Fernandes,1,1,4,6,Ocasional
3374,200,4,5343.96,Maria Fernanda Garcia,1,2,3,6,Ocasional
3375,54,2,2865.44,Isabela Sales,2,1,2,5,Ocasional
3376,58,4,2935.31,Sr. Marcos Vinicius Pereira,2,2,2,6,Ocasional
3377,27,6,8391.439999999999,Laura Ramos,3,3,4,10,VIP
3378,108,6,7517.12,Dra. Laís Fogaça,1,3,4,8,Regular
3379,55,2,705.38,Maria Eduarda Abreu,2,1,1,4,Ocasional
3380,3,8,8262.78,Rael Camargo,4,4,4,12,VIP
3381,170,2,334.14,Alícia Sousa,1,1,1,3,Inativo
3382,21,5,13340.77,Alexandre Novais,3,3,4,10,VIP
3383,7,4,1404.5700000000002,Eloá Moura,4,2,1,7,Regular
3384,3,3,5445.1900000000005,Ravi Carvalho,4,1,3,8,Regular
3385,5,3,2201.37,Maria Liz das Neves,4,1,1,6,Ocasional
3386,73,5,2305.2,Dr. Daniel Pastor,2,3,2,7,Regular
3387,209,3,12160.689999999999,Dra. Natália da Paz,1,1,4,6,Ocasional
3388,52,4,3604.49,Vinicius Leão,2,2,2,6,Ocasional
3389,41,6,2239.42,Sara da Luz,3,3,1,7,Regular
3390,127,2,1664.1599999999999,Lívia Rezende,1,1,1,3,Inativo
3391,5,3,2250.6,Felipe Ferreira,4,1,1,6,Ocasional
3392,39,4,1250.55,Paulo Porto,3,2,1,6,Ocasional
3393,57,4,6641.44,Esther Costela,2,2,3,7,Regular
3394,64,3,1863.21,Helena Aparecida,2,1,1,4,Ocasional
3395,120,3,1884.4099999999999,Sr. Otávio Sales,1,1,1,3,Inativo
3396,120,1,509.42,Camila Camargo,1,1,1,3,Inativo
3397,122,3,4482.38,Isabel Oliveira,1,1,3,5,Ocasional
3398,218,3,1577.88,Marina Farias,1,1,1,3,Inativo
3400,1,5,11266.21,Kevin Cunha,4,3,4,11,VIP
3401,42,6,5407.62,Sr. Diego Marques,3,3,3,9,Regular
3402,88,4,7984.379999999999,Maria Fernanda Machado,1,2,4,7,Regular
3403,27,5,4864.35,Maria Flor Vieira,3,3,3,9,Regular
3404,44,2,501.85,Ian Vasconcelos,2,1,1,4,Ocasional
3405,33,5,1210.3400000000001,Olívia da Luz,3,3,1,7,Regular
3406,16,5,3494.84,Ana Sophia Montenegro,4,3,2,9,Regular
3407,52,5,9840.77,Isabelly Freitas,2,3,4,9,Regular
3408,13,12,10502.09,Luan Silva,4,4,4,12,VIP
3409,2,3,1367.18,Laura Rodrigues,4,1,1,6,Ocasional
3410,54,4,5256.39,Felipe Campos,2,2,3,7,Regular
3411,34,4,4845.31,Larissa Abreu,3,2,3,8,Regular
3412,18,6,2803.73,Maria Isis Araújo,4,3,2,9,Regular
3413,10,5,1993.83,Vinicius Barbosa,4,3,1,8,Regular
3414,85,4,3387.59,Antonella Sousa,2,2,2,6,Ocasional
3415,34,7,3694.8900000000003,Matheus Moraes,3,4,2,9,Regular
3417,12,3,2054.9300000000003,Ana Lívia Farias,4,1,1,6,Ocasional
3418,18,3,3772.77,Maria Fernanda Siqueira,4,1,2,7,Regular
3419,5,5,3741.67,Felipe Cavalcante,4,3,2,9,Regular
3420,31,3,488.53999999999996,Júlia Montenegro,3,1,1,5,Ocasional
3421,104,3,1532.1100000000001,Maria Cecília Sales,1,1,1,3,Inativo
3422,36,6,15926.619999999999,André Campos,3,3,4,10,VIP
3423,143,6,15359.560000000001,Liz Sampaio,1,3,4,8,Regular
3424,4,7,9661.51,Vitor Hugo Casa Grande,4,4,4,12,VIP
3425,5,2,2484.2799999999997,Lunna Pereira,4,1,2,7,Regular
3426,35,6,12180.630000000001,Srta. Amanda Brito,3,3,4,10,VIP
3427,12,5,10423.65,Eloá da Costa,4,3,4,11,VIP
3428,38,6,8306.41,Dra. Isis Gonçalves,3,3,4,10,VIP
3429,14,9,8305.3,Levi da Cruz,4,4,4,12,VIP
3430,3,2,1149.6,Davi Luiz Pinto,4,1,1,6,Ocasional
3431,129,3,1579.2800000000002,Sara Mendonça,1,1,1,3,Inativo
3432,297,1,242.57,Isaque Cunha,1,1,1,3,Inativo
3433,15,5,7057.81,Sabrina Casa Grande,4,3,3,10,VIP
3434,362,1,605.9,Pedro Henrique Souza,1,1,1,3,Inativo
3435,27,5,5566.93,Henry Novais,3,3,3,9,Regular
3436,25,5,6578.97,Eloah Vasconcelos,3,3,3,9,Regular
3437,85,6,13621.83,Fernando Rezende,2,3,4,9,Regular
3438,15,4,2790.24,Sr. Brayan Barros,4,2,2,8,Regular
3439,41,3,963.39,Sr. Leonardo Santos,3,1,1,5,Ocasional
3440,70,3,6336.599999999999,Maria Fernanda Abreu,2,1,3,6,Ocasional
3441,192,5,3565.38,Maria Vitória Cardoso,1,3,2,6,Ocasional
3442,197,5,3790.98,Yuri da Mota,1,3,2,6,Ocasional
3443,265,1,6470.79,Arthur Gabriel Souza,1,1,3,5,Ocasional
3444,11,6,10431.539999999999,Srta. Amanda Peixoto,4,3,4,11,VIP
3445,6,8,7669.13,Heloísa Guerra,4,4,4,12,VIP
3446,41,5,3742.45,Diego da Costa,3,3,2,8,Regular
3447,6,2,1636.09,Emanuella Cunha,4,1,1,6,Ocasional
3448,47,3,2655.42,Heloísa Fogaça,2,1,2,5,Ocasional
3449,88,5,4935.08,Mariana da Cruz,1,3,3,7,Regular
3450,14,2,149.4,Antony Nascimento,4,1,1,6,Ocasional
3451,15,4,5772.31,Apollo Alves,4,2,3,9,Regular
3452,38,3,4567.42,Maria Fernanda Silva,3,1,3,7,Regular
3453,15,6,5811.4400000000005,José Alves,4,3,3,10,VIP
3454,31,6,6821.78,Yasmin Machado,3,3,3,9,Regular
3455,63,4,10855.66,Gustavo Henrique Rios,2,2,4,8,Regular
3457,71,3,6043.41,Agatha Azevedo,2,1,3,6,Ocasional
3458,68,5,2270.6,Dr. Kevin Carvalho,2,3,2,7,Regular
3459,67,3,2581.19,Dr. Ravi Cardoso,2,1,2,5,Ocasional
3460,56,2,2532.4100000000003,Olívia Sousa,2,1,2,5,Ocasional
3461,25,5,3514.11,Vitor Gabriel Barros,3,3,2,8,Regular
3462,4,6,8999.1,Arthur Miguel da Mota,4,3,4,11,VIP
3463,1,4,1638.6399999999999,Rafael Silveira,4,2,1,7,Regular
3464,222,4,3711.4199999999996,Asafe da Cruz,1,2,2,5,Ocasional
3465,22,2,3674.51,Lunna da Costa,3,1,2,6,Ocasional
3466,213,2,1218.28,Fernando Machado,1,1,1,3,Inativo
3467,44,1,754.48,Mirella Albuquerque,2,1,1,4,Ocasional
3468,9,7,12898.2,Lara Cirino,4,4,4,12,VIP
3469,58,7,7091.5,Dr. João Miguel Teixeira,2,4,3,9,Regular
3470,337,1,670.66,Zoe Pastor,1,1,1,3,Inativo
3471,37,9,17857.510000000002,Alexia da Mota,3,4,4,11,VIP
3472,45,9,8350.75,Bianca Sales,2,4,4,10,VIP
3473,46,4,3421.79,Leonardo Novaes,2,2,2,6,Ocasional
3474,79,4,4811.67,João Vitor da Rosa,2,2,3,7,Regular
3475,22,2,1688.3500000000001,Theodoro Martins,3,1,1,5,Ocasional
3476,235,4,11195.31,João Pedro Ribeiro,1,2,4,7,Regular
3477,55,3,3743.21,Vitória Nunes,2,1,2,5,Ocasional
3478,33,5,4986.32,José Pedro da Conceição,3,3,3,9,Regular
3479,11,6,5892.96,João Miguel Martins,4,3,3,10,VIP
3480,38,4,2870.99,Mariane Vargas,3,2,2,7,Regular
3481,9,2,2753.8,Camila Cavalcante,4,1,2,7,Regular
3482,40,5,4242.84,Júlia Costa,3,3,2,8,Regular
3483,51,5,10043.8,Sra. Giovanna Garcia,2,3,4,9,Regular
3484,125,1,105.29,Dr. Cauê Porto,1,1,1,3,Inativo
3485,169,3,8483.72,Josué Sousa,1,1,4,6,Ocasional
3486,44,6,4618.820000000001,Felipe Barbosa,2,3,3,8,Regular
3487,46,3,3080.01,João Rios,2,1,2,5,Ocasional
3488,44,3,1674.91,Luara Rios,2,1,1,4,Ocasional
3489,141,3,5166.14,Dr. Gustavo Henrique Macedo,1,1,3,5,Ocasional
3490,18,6,4242.22,Vitor Caldeira,4,3,2,9,Regular
3491,26,5,4218.59,Heloísa Ferreira,3,3,2,8,Regular
3492,88,3,2528.23,Sr. Thales Dias,1,1,2,4,Ocasional
3493,49,5,7514.17,Davi Lucca Fogaça,2,3,4,9,Regular
3494,23,7,9651.22,Mathias da Luz,3,4,4,11,VIP
3495,43,5,2185.26,Yasmin Moraes,3,3,1,7,Regular
3496,80,6,11698.8,Theo Martins,2,3,4,9,Regular
3497,16,4,2878.23,José Miguel Alves,4,2,2,8,Regular
3498,17,2,297.57,Pedro Henrique Araújo,4,1,1,6,Ocasional
3499,178,2,1492.47,Catarina Fonseca,1,1,1,3,Inativo
3500,346,1,147.9,Henrique Cardoso,1,1,1,3,Inativo
3501,57,1,330.88,Joana da Mata,2,1,1,4,Ocasional
3502,2,5,5441.7,Julia Nunes,4,3,3,10,VIP
3503,51,3,3388.91,Sofia Camargo,2,1,2,5,Ocasional
3504,53,4,3872.2400000000002,Cecília Macedo,2,2,2,6,Ocasional
3505,159,2,950.55,Heitor Peixoto,1,1,1,3,Inativo
3506,70,4,2736.73,Arthur Vargas,2,2,2,6,Ocasional
3507,112,1,54.35,Thiago Barros,1,1,1,3,Inativo
3508,4,6,8372.76,Dra. Elisa Andrade,4,3,4,11,VIP
3509,74,3,2624.79,Catarina Macedo,2,1,2,5,Ocasional
3510,24,6,18184.68,Sra. Helena Sá,3,3,4,10,VIP
3511,48,2,2916.57,Otto Vargas,2,1,2,5,Ocasional
3512,184,2,4533.5599999999995,Maysa Sá,1,1,3,5,Ocasional
3513,146,1,79.26,Maria Helena Vieira,1,1,1,3,Inativo
3514,42,4,1699.62,Sr. André Novais,3,2,1,6,Ocasional
3515,3,6,9523.21,Sr. Renan Pinto,4,3,4,11,VIP
3516,30,5,10497.849999999999,João Guilherme Barros,3,3,4,10,VIP
3517,201,4,7145.29,Srta. Valentina Cassiano,1,2,3,6,Ocasional
3518,63,5,3814.48,Arthur Novais,2,3,2,7,Regular
3519,99,3,418.29,Luna Nunes,1,1,1,3,Inativo
3520,8,5,7971.82,Stella Silveira,4,3,4,11,VIP
3521,24,7,7942.61,Yuri Moura,3,4,4,11,VIP
3522,22,6,6354.679999999999,Sra. Camila Câmara,3,3,3,9,Regular
3523,61,5,1359.04,Lunna Fernandes,2,3,1,6,Ocasional
3524,175,3,6899.59,Maysa Cavalcanti,1,1,3,5,Ocasional
3525,15,5,8151.93,Mariane Fernandes,4,3,4,11,VIP
3526,34,4,3011.88,Yuri da Mata,3,2,2,7,Regular
3527,37,5,6765.58,Juan Pereira,3,3,3,9,Regular
3528,49,1,172.05,Mariah Nunes,2,1,1,4,Ocasional
3529,84,3,7562.320000000001,Maya Marques,2,1,4,7,Regular
3530,116,3,1168.6599999999999,Luiza Cunha,1,1,1,3,Inativo
3531,41,8,2633.14,Pedro Sousa,3,4,2,9,Regular
3532,1,5,4470.7,Agatha da Rocha,4,3,3,10,VIP
3533,29,5,6570.8099999999995,Emanuelly Lopes,3,3,3,9,Regular
3534,74,2,4103.6,Bárbara Casa Grande,2,1,2,5,Ocasional
3535,13,4,6369.719999999999,Dr. Thiago Oliveira,4,2,3,9,Regular
3536,3,3,3963.5099999999998,André Pacheco,4,1,2,7,Regular
3537,62,4,3786.73,Srta. Ana Costa,2,2,2,6,Ocasional
3538,13,4,4029.52,Zoe da Mata,4,2,2,8,Regular
3539,11,4,4460.12,Ana Clara Alves,4,2,3,9,Regular
3540,43,5,9456.29,Benjamim Viana,3,3,4,10,VIP
3541,59,5,9090.74,Maria Helena da Costa,2,3,4,9,Regular
3542,19,6,7175.48,Luan da Cunha,4,3,3,10,VIP
3543,37,3,1337.7,Lorena Azevedo,3,1,1,5,Ocasional
3544,41,5,2394.08,Dra. Sarah Montenegro,3,3,2,8,Regular
3545,46,6,4238.2,Davi Luiz Costela,2,3,2,7,Regular
3546,185,1,2176.85,Heitor Carvalho,1,1,1,3,Inativo
3547,18,4,4655.43,Ana Sophia Fonseca,4,2,3,9,Regular
3548,50,4,2030.42,Isabel Oliveira,2,2,1,5,Ocasional
3549,22,7,2928.42,Milena Sá,3,4,2,9,Regular
3550,96,3,2523.42,Ana Clara Novais,1,1,2,4,Ocasional
3551,21,7,7678.52,Dr. Francisco Barbosa,3,4,4,11,VIP
3552,7,5,6368.17,Cecília Martins,4,3,3,10,VIP
3553,24,4,1396.22,Maria Cecília Sales,3,2,1,6,Ocasional
3554,105,1,1121.71,Kamilly Andrade,1,1,1,3,Inativo
3555,44,8,8705.89,Enrico Borges,2,4,4,10,VIP
3556,61,5,3553.67,Antônio Barros,2,3,2,7,Regular
3557,36,5,4316.73,Luna Fernandes,3,3,2,8,Regular
3558,11,4,3515.7,Sr. João Guilherme Correia,4,2,2,8,Regular
3559,33,3,668.49,Ísis Costa,3,1,1,5,Ocasional
3560,19,7,4966.9800000000005,Marina da Cruz,4,4,3,11,VIP
3561,103,4,4844.4400000000005,Ravi Rezende,1,2,3,6,Ocasional
3562,55,2,1134.15,Dra. Brenda Vasconcelos,2,1,1,4,Ocasional
3563,73,5,4978.4,Gael Henrique Gonçalves,2,3,3,8,Regular
3564,51,2,2070.16,Rafaela Nunes,2,1,1,4,Ocasional
3565,43,3,4226.01,Luara Silveira,3,1,2,6,Ocasional
3566,37,3,3521.21,Sr. Asafe Porto,3,1,2,6,Ocasional
3567,13,5,3237.09,Maitê Lima,4,3,2,9,Regular
3568,27,7,13192.22,João Pedro Correia,3,4,4,11,VIP
3569,257,1,405.59,Anthony Gabriel da Costa,1,1,1,3,Inativo
3570,137,2,3691.95,Kamilly Castro,1,1,2,4,Ocasional
3571,9,9,7751.38,Sr. Heitor Sousa,4,4,4,12,VIP
3572,221,2,2081.4300000000003,Guilherme Borges,1,1,1,3,Inativo
3573,9,5,6400.1900000000005,Luísa Sampaio,4,3,3,10,VIP
3574,16,3,4343.56,Dr. José Miguel Macedo,4,1,2,7,Regular
3575,5,5,8446.560000000001,Cauê da Paz,4,3,4,11,VIP
3576,19,1,88.28,Henrique Vargas,4,1,1,6,Ocasional
3577,19,6,3722.42,Beatriz Costela,4,3,2,9,Regular
3578,28,4,5139.83,Luísa Montenegro,3,2,3,8,Regular
3579,12,10,11628.21,Ana Lívia Cardoso,4,4,4,12,VIP
3580,63,4,4730.9800000000005,Luiz Miguel Dias,2,2,3,7,Regular
3581,14,8,7102.06,Ester Cavalcanti,4,4,3,11,VIP
3582,117,3,1332.98,José Correia,1,1,1,3,Inativo
3583,146,2,4250.29,Dra. Mariah Pastor,1,1,2,4,Ocasional
3584,65,3,7578.24,Enzo Macedo,2,1,4,7,Regular
3585,10,8,5928.66,Sofia Machado,4,4,3,11,VIP
3586,10,2,3385.4,Asafe Albuquerque,4,1,2,7,Regular
3587,52,5,8055.099999999999,Olívia Machado,2,3,4,9,Regular
3588,101,6,2542.33,Ravi Rezende,1,3,2,6,Ocasional
3589,20,8,8432.23,Marcos Vinicius Fogaça,3,4,4,11,VIP
3590,66,8,13076.41,Ravi Lucca Dias,2,4,4,10,VIP
3591,18,6,3139.8100000000004,Maria Alice Santos,4,3,2,9,Regular
3592,72,9,11628.57,Henry Machado,2,4,4,10,VIP
3593,203,3,2487.25,Emanuel Cirino,1,1,2,4,Ocasional
3594,23,4,5307.1,Maria Eduarda Silveira,3,2,3,8,Regular
3595,92,3,6106.95,Bernardo da Paz,1,1,3,5,Ocasional
3596,63,3,4264.4,Yago Barbosa,2,1,2,5,Ocasional
3597,91,2,656.49,Luiz Miguel Porto,1,1,1,3,Inativo
3598,60,4,2196.14,Caio Silva,2,2,1,5,Ocasional
3600,43,3,3336.6000000000004,Maria Luiza Marques,3,1,2,6,Ocasional
3601,1,7,10532.380000000001,Maria Flor Pereira,4,4,4,12,VIP
3602,53,1,371.98,Maria Alice Siqueira,2,1,1,4,Ocasional
3603,257,3,2246.62,Rhavi Vieira,1,1,1,3,Inativo
3604,78,3,6882.2300000000005,Luan Machado,2,1,3,6,Ocasional
3605,79,2,3900.7300000000005,Eloah Melo,2,1,2,5,Ocasional
3606,38,1,245.79,José Porto,3,1,1,5,Ocasional
3607,10,1,480.62,Matheus Borges,4,1,1,6,Ocasional
3608,117,7,9367.33,Dra. Stephany Sampaio,1,4,4,9,Regular
3609,40,7,8225.6,Maria Cecília Barros,3,4,4,11,VIP
3610,6,6,7007.71,Vitor Hugo da Conceição,4,3,3,10,VIP
3611,49,2,2791.6299999999997,João Felipe Melo,2,1,2,5,Ocasional
3612,43,5,7604.51,Yuri Abreu,3,3,4,10,VIP
3613,115,2,4590.93,Maria Clara Cirino,1,1,3,5,Ocasional
3614,35,7,4470.32,Joaquim Gonçalves,3,4,3,10,VIP
3615,23,3,1479.31,Joaquim Campos,3,1,1,5,Ocasional
3616,191,1,213.48,Joaquim Brito,1,1,1,3,Inativo
3617,50,5,12620.57,Srta. Anna Liz Martins,2,3,4,9,Regular
3618,45,3,2682.13,Thomas Vasconcelos,2,1,2,5,Ocasional
3619,54,5,6611.289999999999,Danilo Martins,2,3,3,8,Regular
3620,15,4,7982.84,Arthur Gabriel da Cunha,4,2,4,10,VIP
3621,47,2,503.84000000000003,Bruna Cavalcanti,2,1,1,4,Ocasional
3622,28,8,11378.42,Srta. Emanuelly da Luz,3,4,4,11,VIP
3623,6,6,8364.34,Asafe Castro,4,3,4,11,VIP
3624,11,5,1360.1000000000001,Vinícius Souza,4,3,1,8,Regular
3625,35,3,6655.87,Melissa Montenegro,3,1,3,7,Regular
3626,129,3,2122.95,Sr. Lucas Gabriel Correia,1,1,1,3,Inativo
3627,9,5,9972.1,Asafe Pimenta,4,3,4,11,VIP
3628,23,5,5872.700000000001,Breno Pereira,3,3,3,9,Regular
3629,17,3,618.95,Theodoro Dias,4,1,1,6,Ocasional
3630,196,4,8163.860000000001,Isis Lopes,1,2,4,7,Regular
3631,21,4,4971.1,Rael Gonçalves,3,2,3,8,Regular
3633,20,5,6590.08,Amanda Campos,3,3,3,9,Regular
3634,3,4,7332.959999999999,José Miguel Alves,4,2,4,10,VIP
3635,89,3,3181.08,Sr. Felipe da Rosa,1,1,2,4,Ocasional
3636,9,6,3433.79,Renan Barbosa,4,3,2,9,Regular
3637,295,1,87.83,Maya Moraes,1,1,1,3,Inativo
3638,6,8,8489.44,Pietro Sousa,4,4,4,12,VIP
3639,127,3,2340.3,Bárbara Oliveira,1,1,2,4,Ocasional
3640,8,7,6111.3099999999995,Nicole Macedo,4,4,3,11,VIP
3641,21,3,7882.8,Calebe Mendes,3,1,4,8,Regular
3642,32,2,501.41,Nina Teixeira,3,1,1,5,Ocasional
3643,145,5,9149.5,Sr. Leandro Machado,1,3,4,8,Regular
3644,86,4,2567.8799999999997,Luiz Gustavo Porto,2,2,2,6,Ocasional
3645,4,6,5210.969999999999,Emanuella Marques,4,3,3,10,VIP
3646,238,3,4588.84,José Miguel Alves,1,1,3,5,Ocasional
3647,34,8,21666.54,Vitor da Paz,3,4,4,11,VIP
3648,94,5,2155.86,Manuella Cardoso,1,3,1,5,Ocasional
3649,38,8,8308.0,Renan da Cruz,3,4,4,11,VIP
3650,92,6,8493.08,Mariana Correia,1,3,4,8,Regular
3651,35,6,20255.170000000002,Marcelo Gonçalves,3,3,4,10,VIP
3652,32,3,8430.46,Mariah Cirino,3,1,4,8,Regular
3653,10,8,11179.189999999999,Sr. Leandro Costela,4,4,4,12,VIP
3654,11,5,5307.5,Julia da Rocha,4,3,3,10,VIP
3655,58,4,4541.16,Luiz Otávio Barbosa,2,2,3,7,Regular
3656,67,3,5736.74,Mathias da Paz,2,1,3,6,Ocasional
3657,11,3,611.1800000000001,Vitória Monteiro,4,1,1,6,Ocasional
3658,48,6,7799.28,Léo Rezende,2,3,4,9,Regular
3659,103,1,403.36,Lucca Martins,1,1,1,3,Inativo
3660,28,6,10833.62,Davi Miguel da Cunha,3,3,4,10,VIP
3661,16,5,4999.3,Eloá das Neves,4,3,3,10,VIP
3662,23,4,2383.3,Dra. Maria Julia Camargo,3,2,2,7,Regular
3663,109,3,2460.83,Benício Moreira,1,1,2,4,Ocasional
3664,89,4,6982.59,João Felipe Macedo,1,2,3,6,Ocasional
3665,11,3,5626.7,Srta. Anna Liz Leão,4,1,3,8,Regular
3666,69,2,7231.18,Ágatha Leão,2,1,3,6,Ocasional
3667,56,5,2249.69,Yan da Rocha,2,3,1,6,Ocasional
3668,10,5,5593.5199999999995,Milena Montenegro,4,3,3,10,VIP
3669,24,6,5599.05,Davi Luiz da Cunha,3,3,3,9,Regular
3670,94,2,1424.46,Mariana Azevedo,1,1,1,3,Inativo
3671,91,5,6163.450000000001,Olivia Sampaio,1,3,3,7,Regular
3672,18,3,2660.5699999999997,Dr. Rhavi Oliveira,4,1,2,7,Regular
3673,97,4,5104.41,Luana Silveira,1,2,3,6,Ocasional
3674,66,5,7223.8,Bella Dias,2,3,3,8,Regular
3675,118,3,10766.46,Amanda Carvalho,1,1,4,6,Ocasional
3676,281,3,1982.51,Ravi Lucca Gonçalves,1,1,1,3,Inativo
3677,2,4,4123.639999999999,Davi Lucca Gomes,4,2,2,8,Regular
3678,54,6,7774.76,João Lucas Ferreira,2,3,4,9,Regular
3679,60,4,2699.39,Sr. João Guilherme Ramos,2,2,2,6,Ocasional
3680,55,5,5069.200000000001,Maria Cecília Vasconcelos,2,3,3,8,Regular
3681,180,3,626.06,Lucas Souza,1,1,1,3,Inativo
3682,15,6,2906.32,Sr. Emanuel Mendes,4,3,2,9,Regular
3683,87,5,1639.9800000000002,Sara da Cunha,2,3,1,6,Ocasional
3684,4,9,9047.279999999999,Julia Teixeira,4,4,4,12,VIP
3685,42,5,4337.87,Luiza Câmara,3,3,2,8,Regular
3686,33,3,1642.19,Oliver Barbosa,3,1,1,5,Ocasional
3688,7,2,1600.04,Emanuelly Rezende,4,1,1,6,Ocasional
3689,30,6,1816.9699999999998,Benício Mendes,3,3,1,7,Regular
3690,64,2,3036.95,Thiago Freitas,2,1,2,5,Ocasional
3691,15,7,9323.42,Ana Júlia Rios,4,4,4,12,VIP
3692,36,5,4332.79,Ágatha Aragão,3,3,2,8,Regular
3693,122,2,863.5,Sra. Sara Marques,1,1,1,3,Inativo
3694,50,4,1709.6699999999998,Dr. Lucas Pinto,2,2,1,5,Ocasional
3695,41,8,14850.130000000001,Sra. Gabriela Fogaça,3,4,4,11,VIP
3696,250,3,2124.25,Isaac Aragão,1,1,1,3,Inativo
3697,63,2,1151.04,Ana Lívia das Neves,2,1,1,4,Ocasional
3698,44,5,5012.2,Otávio Albuquerque,2,3,3,8,Regular
3699,36,2,1405.0900000000001,Sra. Lorena Montenegro,3,1,1,5,Ocasional
3700,256,2,4026.3,Davi Luiz Marques,1,1,2,4,Ocasional
3701,3,3,1230.8400000000001,Eloá Ferreira,4,1,1,6,Ocasional
3702,15,3,1396.54,Enrico Freitas,4,1,1,6,Ocasional
3703,3,4,4095.71,Dra. Letícia Pereira,4,2,2,8,Regular
3704,165,5,4330.18,Levi Gonçalves,1,3,2,6,Ocasional
3705,17,3,4787.639999999999,José Pedro Barbosa,4,1,3,8,Regular
3706,193,2,608.04,Alexia Viana,1,1,1,3,Inativo
3707,8,6,6930.31,Marcos Vinicius Machado,4,3,3,10,VIP
3708,42,8,13221.85,Davi Lucas Montenegro,3,4,4,11,VIP
3709,48,6,3469.77,Thales da Costa,2,3,2,7,Regular
3710,86,5,8842.26,Sra. Carolina Rodrigues,2,3,4,9,Regular
3711,49,2,680.3199999999999,Emanuelly Silva,2,1,1,4,Ocasional
3712,47,4,6784.950000000001,Sr. Otávio Gonçalves,2,2,3,7,Regular
3713,83,3,7308.179999999999,Maria Vitória Barros,2,1,3,6,Ocasional
3714,256,3,1952.81,Srta. Maria Julia da Cunha,1,1,1,3,Inativo
3715,52,4,7340.83,Henry Costela,2,2,4,8,Regular
3716,32,5,8306.36,Maria Luiza Azevedo,3,3,4,10,VIP
3717,57,7,7004.92,Maria Julia Pacheco,2,4,3,9,Regular
3718,2,8,5432.47,Maria Luísa Sousa,4,4,3,11,VIP
3720,156,4,9482.0,Srta. Mariana da Cunha,1,2,4,7,Regular
3721,3,5,7352.0599999999995,Srta. Brenda Mendonça,4,3,4,11,VIP
3722,50,2,451.22,Isabelly Martins,2,1,1,4,Ocasional
3723,50,3,1889.5,Erick Correia,2,1,1,4,Ocasional
3724,25,9,7868.85,Mirella Freitas,3,4,4,11,VIP
3725,92,3,2133.58,Alexandre da Rosa,1,1,1,3,Inativo
3726,228,3,2048.96,Leandro Vargas,1,1,1,3,Inativo
3727,22,8,9498.12,Luigi Jesus,3,4,4,11,VIP
3728,4,4,4434.8099999999995,Agatha Rodrigues,4,2,3,9,Regular
3729,1,7,11697.16,Lívia Costa,4,4,4,12,VIP
3730,5,2,3659.6600000000003,Ana Costela,4,1,2,7,Regular
3731,27,6,2172.96,Liz Mendes,3,3,1,7,Regular
3732,38,5,2309.79,Dr. Lucca Albuquerque,3,3,2,8,Regular
3733,37,5,10891.73,Lara Alves,3,3,4,10,VIP
3734,6,4,12530.74,Gabriela Cassiano,4,2,4,10,VIP
3735,45,8,11132.58,Manuela Aragão,2,4,4,10,VIP
3736,44,3,1022.47,Miguel Farias,2,1,1,4,Ocasional
3737,29,3,1686.1399999999999,Dra. Sofia da Costa,3,1,1,5,Ocasional
3738,33,4,1633.33,Maria Sophia da Mata,3,2,1,6,Ocasional
3739,36,2,1673.3899999999999,Sr. Thomas Cavalcante,3,1,1,5,Ocasional
3740,16,3,4581.89,Amanda Cardoso,4,1,3,8,Regular
3741,183,1,210.17,Maria Laura Barbosa,1,1,1,3,Inativo
3742,198,1,176.28,Caleb Sampaio,1,1,1,3,Inativo
3743,16,4,1138.77,Maria Clara Sá,4,2,1,7,Regular
3744,22,9,8685.71,Maria Isis Caldeira,3,4,4,11,VIP
3745,68,2,1941.9,Cecilia Alves,2,1,1,4,Ocasional
3746,271,1,2438.61,Mariane Gonçalves,1,1,2,4,Ocasional
3747,128,4,2908.83,Juan Vasconcelos,1,2,2,5,Ocasional
3748,9,6,5210.83,Agatha Ferreira,4,3,3,10,VIP
3749,77,7,19063.1,Liam da Luz,2,4,4,10,VIP
3750,83,1,245.66,Alana Pastor,2,1,1,4,Ocasional
3751,26,2,7225.02,Dr. Vitor Campos,3,1,3,7,Regular
3752,2,6,1893.1799999999998,Mariah Cardoso,4,3,1,8,Regular
3753,122,4,1306.75,Anthony Gabriel Borges,1,2,1,4,Ocasional
3754,49,3,5435.17,Benjamin Andrade,2,1,3,6,Ocasional
3755,25,5,4976.2699999999995,Srta. Luana Siqueira,3,3,3,9,Regular
3756,66,3,5705.08,Kamilly Caldeira,2,1,3,6,Ocasional
3757,83,4,2423.39,Diego Caldeira,2,2,2,6,Ocasional
3758,72,4,4705.5599999999995,Emanuella Fogaça,2,2,3,7,Regular
3759,58,3,4996.93,Anthony Gabriel Oliveira,2,1,3,6,Ocasional
3760,61,3,3363.71,Ana Carolina Siqueira,2,1,2,5,Ocasional
3761,147,4,4794.49,Ana Carolina Pires,1,2,3,6,Ocasional
3762,301,2,3012.86,Antony Ramos,1,1,2,4,Ocasional
3763,26,4,2104.52,Antônio Moura,3,2,1,6,Ocasional
3764,44,4,4941.59,Gabrielly Porto,2,2,3,7,Regular
3765,18,7,2380.56,Ravy Campos,4,4,2,10,VIP
3766,7,8,8856.58,Breno Melo,4,4,4,12,VIP
3767,37,4,2883.4,Yuri Pereira,3,2,2,7,Regular
3768,11,4,1917.99,Júlia Andrade,4,2,1,7,Regular
3769,35,5,2597.1099999999997,Rebeca Moura,3,3,2,8,Regular
3770,55,6,9989.24,Emanuella Garcia,2,3,4,9,Regular
3771,14,3,1355.93,Luiz Otávio Brito,4,1,1,6,Ocasional
3772,38,5,4931.58,Valentim Nascimento,3,3,3,9,Regular
3773,6,6,3185.4300000000003,Maria Clara Caldeira,4,3,2,9,Regular
3774,248,3,5844.379999999999,Sr. Liam Marques,1,1,3,5,Ocasional
3775,216,2,2408.47,Yasmin Albuquerque,1,1,2,4,Ocasional
3776,168,1,3628.76,Sr. Felipe Teixeira,1,1,2,4,Ocasional
3777,164,4,9472.39,Sra. Maria Flor Costa,1,2,4,7,Regular
3778,28,3,8268.619999999999,Sr. João Lucas Vargas,3,1,4,8,Regular
3779,37,3,1066.95,Catarina Guerra,3,1,1,5,Ocasional
3780,34,5,2131.14,Srta. Nicole Borges,3,3,1,7,Regular
3781,239,2,3210.55,Maria Flor Pacheco,1,1,2,4,Ocasional
3782,43,2,13454.060000000001,Gustavo Henrique Rodrigues,3,1,4,8,Regular
3783,60,3,860.46,Davi Vieira,2,1,1,4,Ocasional
3784,328,1,3024.28,Agatha Teixeira,1,1,2,4,Ocasional
3785,98,7,4795.14,Dr. João Lucas Azevedo,1,4,3,8,Regular
3786,10,5,6068.51,Igor Ferreira,4,3,3,10,VIP
3787,305,1,195.62,Luan Rios,1,1,1,3,Inativo
3788,123,3,3849.0,Maya Rezende,1,1,2,4,Ocasional
3789,6,6,2483.87,Maria Luísa Nascimento,4,3,2,9,Regular
3790,35,5,5322.75,Emanuella Costela,3,3,3,9,Regular
3791,190,4,5550.99,Lavínia Gonçalves,1,2,3,6,Ocasional
3792,5,3,3251.36,Yuri da Rocha,4,1,2,7,Regular
3793,93,3,10538.89,Théo Vargas,1,1,4,6,Ocasional
3794,122,4,3514.78,Theo da Paz,1,2,2,5,Ocasional
3795,61,2,3969.96,Ana Beatriz da Conceição,2,1,2,5,Ocasional
3796,28,2,1227.24,Vinicius da Mota,3,1,1,5,Ocasional
3797,52,7,3067.2599999999998,Maria Flor Cassiano,2,4,2,8,Regular
3798,34,6,6122.299999999999,Arthur Miguel Garcia,3,3,3,9,Regular
3799,57,5,11148.61,Otto Pastor,2,3,4,9,Regular
3800,27,1,374.45,Bianca Silveira,3,1,1,5,Ocasional
3801,4,8,4736.44,Ísis Nogueira,4,4,3,11,VIP
3802,114,3,9087.05,João Guilherme Cassiano,1,1,4,6,Ocasional
3803,11,6,8289.3,Bernardo Ramos,4,3,4,11,VIP
3804,79,5,3101.44,Luiz Felipe Porto,2,3,2,7,Regular
3805,248,2,10151.65,Gael Henrique Vasconcelos,1,1,4,6,Ocasional
3806,123,4,3923.95,Srta. Eloá Nunes,1,2,2,5,Ocasional
3807,61,3,3907.05,Thiago Rios,2,1,2,5,Ocasional
3808,49,6,3278.71,Agatha Campos,2,3,2,7,Regular
3809,64,7,5667.03,Rhavi Sousa,2,4,3,9,Regular
3810,16,5,4734.360000000001,Josué Sales,4,3,3,10,VIP
3811,82,4,2259.22,Isaque Novais,2,2,1,5,Ocasional
3812,82,6,7405.49,Maria Júlia Fogaça,2,3,4,9,Regular
3813,276,2,2524.02,Allana Correia,1,1,2,4,Ocasional
3814,36,4,7969.99,Davi Lucas Pastor,3,2,4,9,Regular
3815,16,3,1177.81,Bianca Farias,4,1,1,6,Ocasional
3816,147,2,2401.8900000000003,Bento Pimenta,1,1,2,4,Ocasional
3817,5,6,9021.93,Brayan Melo,4,3,4,11,VIP
3818,34,3,6923.62,Dr. Vinícius Rocha,3,1,3,7,Regular
3819,67,3,9654.64,Marcos Vinicius Guerra,2,1,4,7,Regular
3820,2,2,1862.17,Ravy da Luz,4,1,1,6,Ocasional
3821,17,3,4539.32,Giovanna Montenegro,4,1,3,8,Regular
3822,8,4,5328.969999999999,Sr. Murilo Almeida,4,2,3,9,Regular
3823,143,2,970.63,Mariah Novais,1,1,1,3,Inativo
3824,53,4,3538.42,Luara Cassiano,2,2,2,6,Ocasional
3825,171,1,90.09,Heloísa Sá,1,1,1,3,Inativo
3826,210,2,3588.86,Ana Cecília Moreira,1,1,2,4,Ocasional
3827,24,3,3842.49,Bryan da Cunha,3,1,2,6,Ocasional
3828,31,2,3633.2599999999998,Milena Martins,3,1,2,6,Ocasional
3829,76,4,2016.6,Dr. Lucca Oliveira,2,2,1,5,Ocasional
3830,46,7,6809.18,Isis Almeida,2,4,3,9,Regular
3831,23,5,8601.91,Juan Camargo,3,3,4,10,VIP
3832,33,5,4632.89,Cauã Rodrigues,3,3,3,9,Regular
3833,82,3,1383.81,Nicole Cirino,2,1,1,4,Ocasional
3834,7,3,435.2,Dr. Otto Machado,4,1,1,6,Ocasional
3835,46,5,3321.69,Cecília Vargas,2,3,2,7,Regular
3836,34,5,3429.4100000000003,Ana Luiza Pinto,3,3,2,8,Regular
3837,221,4,1073.73,Dr. Gael Martins,1,2,1,4,Ocasional
3838,103,4,6805.09,Luna Freitas,1,2,3,6,Ocasional
3839,89,4,8544.79,José Miguel Novaes,1,2,4,7,Regular
3840,10,5,4412.83,Pedro Miguel Freitas,4,3,3,10,VIP
3841,1,10,8836.83,Pedro Miguel Vargas,4,4,4,12,VIP
3842,26,2,1064.54,Luísa Souza,3,1,1,5,Ocasional
3843,16,4,4776.54,Dra. Clarice Freitas,4,2,3,9,Regular
3844,38,4,13707.48,Dr. Pietro Siqueira,3,2,4,9,Regular
3846,155,3,661.74,Natália Campos,1,1,1,3,Inativo
3847,156,2,920.3599999999999,Srta. Jade Araújo,1,1,1,3,Inativo
3848,2,7,11507.66,Nicolas Rodrigues,4,4,4,12,VIP
3849,52,7,5591.41,Brenda Cassiano,2,4,3,9,Regular
3850,96,4,1824.07,Sr. Noah Vieira,1,2,1,4,Ocasional
3851,49,9,10475.13,Beatriz Mendonça,2,4,4,10,VIP
3853,25,7,13532.01,Júlia Mendes,3,4,4,11,VIP
3854,7,9,10251.28,Ana Clara Rodrigues,4,4,4,12,VIP
3855,49,5,3531.96,Sra. Ana Beatriz Ribeiro,2,3,2,7,Regular
3856,8,6,11101.759999999998,Eduardo Vieira,4,3,4,11,VIP
3857,263,2,2543.23,Luan da Conceição,1,1,2,4,Ocasional
3858,29,6,7563.66,Henry Farias,3,3,4,10,VIP
3859,249,2,3539.1600000000003,Sr. Isaque Moreira,1,1,2,4,Ocasional
3860,34,3,1908.52,Maria Isis da Rocha,3,1,1,5,Ocasional
3861,56,6,5516.86,Luiz Fernando Rios,2,3,3,8,Regular
3862,26,4,3609.6800000000003,João Vitor Borges,3,2,2,7,Regular
3863,80,2,1084.86,Clarice Guerra,2,1,1,4,Ocasional
3864,35,7,6723.2,Manuella Azevedo,3,4,3,10,VIP
3866,2,7,6546.71,Sr. Benício Pinto,4,4,3,11,VIP
3867,60,3,1727.81,Miguel da Mota,2,1,1,4,Ocasional
3868,6,5,2793.86,Davi Lucas Rocha,4,3,2,9,Regular
3869,47,4,2761.11,Enzo Pacheco,2,2,2,6,Ocasional
3870,62,5,3002.54,Isis da Cruz,2,3,2,7,Regular
3871,2,6,7079.9800000000005,Isadora Albuquerque,4,3,3,10,VIP
3872,54,7,7214.57,Ana Cecília Nogueira,2,4,3,9,Regular
3873,7,6,2881.15,Sr. Yuri Sousa,4,3,2,9,Regular
3874,67,2,1809.24,Marina Pastor,2,1,1,4,Ocasional
3875,19,5,3776.85,Liz Leão,4,3,2,9,Regular
3876,132,3,2777.34,Diego Montenegro,1,1,2,4,Ocasional
3877,36,3,2833.8199999999997,Juliana Pinto,3,1,2,6,Ocasional
3878,37,4,2766.61,Bruno Silveira,3,2,2,7,Regular
3879,97,3,4452.41,Dr. Théo Pires,1,1,3,5,Ocasional
3880,147,2,3061.94,Maria Laura da Rocha,1,1,2,4,Ocasional
3881,30,4,5274.5199999999995,Dra. Luna Correia,3,2,3,8,Regular
3882,30,6,8595.17,Rebeca Gomes,3,3,4,10,VIP
3883,40,4,4829.57,Dr. José Duarte,3,2,3,8,Regular
3884,53,3,8811.26,Joaquim das Neves,2,1,4,7,Regular
3885,17,3,4615.549999999999,Olívia Moraes,4,1,3,8,Regular
3886,192,2,1391.47,Dr. Gael Henrique Cavalcanti,1,1,1,3,Inativo
3887,16,5,5477.61,Bryan Cavalcanti,4,3,3,10,VIP
3888,18,3,2451.16,Manuella Fernandes,4,1,2,7,Regular
3889,1,6,5003.139999999999,Théo Almeida,4,3,3,10,VIP
3890,38,8,10783.02,Sr. Davi Luiz Souza,3,4,4,11,VIP
3891,93,6,2759.07,Hadassa da Mota,1,3,2,6,Ocasional
3892,22,2,1631.36,Francisco da Costa,3,1,1,5,Ocasional
3893,7,6,10470.949999999999,Mariana Porto,4,3,4,11,VIP
3894,38,6,3997.1400000000003,Srta. Anna Liz Ribeiro,3,3,2,8,Regular
3895,4,5,4484.29,Emanuella Gonçalves,4,3,3,10,VIP
3896,240,1,2663.36,Sr. Gabriel Souza,1,1,2,4,Ocasional
3897,17,2,3027.79,Luiz Miguel Teixeira,4,1,2,7,Regular
3898,57,7,4231.389999999999,Sr. Enzo Caldeira,2,4,2,8,Regular
3899,169,4,6554.67,Vinícius da Conceição,1,2,3,6,Ocasional
3900,30,4,6886.0599999999995,João Pedro Martins,3,2,3,8,Regular
3901,92,1,16.4,Isabelly Rodrigues,1,1,1,3,Inativo
3902,59,5,16668.190000000002,Dr. Nicolas Barros,2,3,4,9,Regular
3903,45,4,2605.73,Milena Moura,2,2,2,6,Ocasional
3904,2,9,8160.68,Henry Gabriel Oliveira,4,4,4,12,VIP
3905,181,2,1107.09,Sra. Emanuella da Conceição,1,1,1,3,Inativo
3906,21,4,8873.21,Murilo Rocha,3,2,4,9,Regular
3907,357,1,1193.27,Sabrina Rocha,1,1,1,3,Inativo
3908,149,6,7454.9800000000005,Antônio Aparecida,1,3,4,8,Regular
3909,37,5,3261.1,Ana Laura Gonçalves,3,3,2,8,Regular
3910,38,6,2879.9,Ana Cecília Nunes,3,3,2,8,Regular
3911,323,1,153.08,Sra. Maria Moraes,1,1,1,3,Inativo
3912,23,5,3993.94,Matteo Lima,3,3,2,8,Regular
3913,16,7,11069.25,Ravi Cassiano,4,4,4,12,VIP
3914,34,6,2744.72,Nicole Freitas,3,3,2,8,Regular
3915,9,8,9351.68,Mathias Vargas,4,4,4,12,VIP
3916,32,5,5048.02,Dra. Maysa Peixoto,3,3,3,9,Regular
3917,35,4,2434.57,Ana Viana,3,2,2,7,Regular
3918,110,5,7894.75,Maria Júlia Santos,1,3,4,8,Regular
3919,129,4,5036.53,Srta. Natália Campos,1,2,3,6,Ocasional
3920,31,4,6730.540000000001,Benicio Cunha,3,2,3,8,Regular
3921,5,5,2891.43,Dr. Vitor Machado,4,3,2,9,Regular
3922,14,11,9950.66,Srta. Sara Cavalcanti,4,4,4,12,VIP
3923,90,6,3407.92,Fernando Rodrigues,1,3,2,6,Ocasional
3924,275,1,5262.88,Cauê Vargas,1,1,3,5,Ocasional
3925,63,3,1387.9199999999998,Liam Azevedo,2,1,1,4,Ocasional
3926,67,3,2164.6000000000004,Dante Vieira,2,1,1,4,Ocasional
3927,281,1,2745.96,Dra. Ana Laura da Rosa,1,1,2,4,Ocasional
3929,15,2,912.4300000000001,Ísis Gonçalves,4,1,1,6,Ocasional
3930,22,4,8928.17,Ana Carolina Melo,3,2,4,9,Regular
3931,56,5,7342.67,Rhavi Albuquerque,2,3,4,9,Regular
3932,23,3,1295.28,Heitor Cardoso,3,1,1,5,Ocasional
3933,266,2,1449.39,Pedro Henrique Teixeira,1,1,1,3,Inativo
3934,9,3,1193.59,Vinicius da Mata,4,1,1,6,Ocasional
3935,24,6,10733.310000000001,Maria Clara Fernandes,3,3,4,10,VIP
3936,59,5,1440.88,Rebeca Rios,2,3,1,6,Ocasional
3937,13,7,3560.42,Srta. Heloisa da Costa,4,4,2,10,VIP
3938,82,5,2214.18,Dr. Kaique Mendonça,2,3,1,6,Ocasional
3939,49,3,4309.54,Maria Cecília Duarte,2,1,2,5,Ocasional
3940,13,5,4237.4,Yan Fogaça,4,3,2,9,Regular
3941,15,5,2935.3399999999997,Sr. Lucca Nogueira,4,3,2,9,Regular
3942,70,3,1042.75,Mariah Mendonça,2,1,1,4,Ocasional
3943,92,6,4312.82,Dra. Mariane Garcia,1,3,2,6,Ocasional
3944,57,4,11632.720000000001,Kaique Macedo,2,2,4,8,Regular
3945,20,5,3035.39,Eduardo Vieira,3,3,2,8,Regular
3946,305,1,1806.31,Lavínia Costela,1,1,1,3,Inativo
3947,236,3,2634.9700000000003,Anthony Dias,1,1,2,4,Ocasional
3948,10,3,2741.67,Breno da Mata,4,1,2,7,Regular
3949,22,7,2403.29,Sr. Caleb Macedo,3,4,2,9,Regular
3950,11,5,10022.05,Dr. Kaique Montenegro,4,3,4,11,VIP
3951,111,3,2131.7799999999997,João Vieira,1,1,1,3,Inativo
3952,229,2,1656.04,Rafaela da Mota,1,1,1,3,Inativo
3953,134,3,4526.7,Mirella Macedo,1,1,3,5,Ocasional
3954,20,4,3913.8,Zoe Câmara,3,2,2,7,Regular
3955,51,3,1329.29,Dr. Luiz Fernando Sousa,2,1,1,4,Ocasional
3956,5,10,8914.11,Dra. Ana Lívia Oliveira,4,4,4,12,VIP
3957,12,4,12089.32,Bella Carvalho,4,2,4,10,VIP
3958,192,2,2754.99,Léo Pimenta,1,1,2,4,Ocasional
3959,118,4,946.51,Theodoro Cirino,1,2,1,4,Ocasional
3960,69,1,43.0,Olivia Montenegro,2,1,1,4,Ocasional
3961,132,1,499.72,Hellena Pacheco,1,1,1,3,Inativo
3962,12,3,4715.4400000000005,Sarah Duarte,4,1,3,8,Regular
3963,11,6,4398.48,Maria Liz Castro,4,3,3,10,VIP
3964,152,3,7056.5199999999995,Nathan Fogaça,1,1,3,5,Ocasional
3965,4,5,3153.1,Liz Rios,4,3,2,9,Regular
3966,2,4,10651.89,Yuri Vargas,4,2,4,10,VIP
3967,65,6,12401.27,Natália Rios,2,3,4,9,Regular
3968,33,5,3341.75,Yan Abreu,3,3,2,8,Regular
3969,46,7,4847.42,Maria Eduarda Andrade,2,4,3,9,Regular
3970,44,2,352.08,Melissa Cirino,2,1,1,4,Ocasional
3971,59,7,10564.12,Milena Viana,2,4,4,10,VIP
3972,47,5,2936.71,Daniela Camargo,2,3,2,7,Regular
3973,301,1,5711.34,Evelyn Nunes,1,1,3,5,Ocasional
3974,78,6,2553.73,Sarah Costela,2,3,2,7,Regular
3975,12,2,1128.95,Maria Laura Lima,4,1,1,6,Ocasional
3976,20,3,3710.7200000000003,Luan da Rocha,3,1,2,6,Ocasional
3977,41,6,9877.65,Juan Aparecida,3,3,4,10,VIP
3978,41,6,4064.6899999999996,Dr. Vinícius Machado,3,3,2,8,Regular
3979,51,5,6157.66,Augusto Moura,2,3,3,8,Regular
3980,191,3,2189.52,Ravi Lucca Sousa,1,1,1,3,Inativo
3981,88,2,912.09,Bruna Borges,1,1,1,3,Inativo
3982,13,4,3836.31,Pedro Lucas Ribeiro,4,2,2,8,Regular
3983,98,2,1949.25,Cecilia Cardoso,1,1,1,3,Inativo
3984,37,6,11004.460000000001,Isaque Farias,3,3,4,10,VIP
3985,218,2,2119.77,Hadassa Novais,1,1,1,3,Inativo
3986,95,4,2154.18,Aylla Mendonça,1,2,1,4,Ocasional
3987,39,4,2093.7799999999997,João Gabriel Ramos,3,2,1,6,Ocasional
3988,14,4,5437.530000000001,Luiz Henrique Cunha,4,2,3,9,Regular
3990,50,3,5054.07,Giovanna Barbosa,2,1,3,6,Ocasional
3991,29,3,793.22,Bella Câmara,3,1,1,5,Ocasional
3992,61,4,5883.629999999999,Luiz Otávio Aragão,2,2,3,7,Regular
3993,19,7,6039.61,Daniel Cassiano,4,4,3,11,VIP
3994,40,3,2974.67,Enrico Viana,3,1,2,6,Ocasional
3995,5,3,2955.99,Sofia Pimenta,4,1,2,7,Regular
3996,15,7,6848.52,Aylla Lima,4,4,3,11,VIP
3997,54,3,3405.96,Pietro Borges,2,1,2,5,Ocasional
3998,8,4,3252.79,João Miguel Ferreira,4,2,2,8,Regular
3999,198,2,5176.29,Bruna Câmara,1,1,3,5,Ocasional
4000,17,6,4038.39,Evelyn Macedo,4,3,2,9,Regular
4001,48,3,1927.44,Maria Vitória Abreu,2,1,1,4,Ocasional
4002,12,8,9840.47,Alexandre Vieira,4,4,4,12,VIP
4003,20,5,5516.99,Dr. Luigi Gomes,3,3,3,9,Regular
4004,11,5,11202.0,Jade Campos,4,3,4,11,VIP
4005,8,6,5962.14,Rodrigo Fernandes,4,3,3,10,VIP
4006,2,1,297.29,Emanuella Sampaio,4,1,1,6,Ocasional
4007,20,6,3698.16,Arthur Gabriel Sales,3,3,2,8,Regular
4008,22,2,1245.81,Olivia Castro,3,1,1,5,Ocasional
4009,56,6,5630.3,Maysa da Rocha,2,3,3,8,Regular
4010,89,5,2144.23,Zoe Machado,1,3,1,5,Ocasional
4011,149,1,645.43,Evelyn Viana,1,1,1,3,Inativo
4012,11,7,6871.03,Sra. Maria Luísa Montenegro,4,4,3,11,VIP
4013,3,2,549.25,Gabriel Barbosa,4,1,1,6,Ocasional
4014,33,7,9444.51,Luigi da Cruz,3,4,4,11,VIP
4015,172,3,6479.34,Sr. Théo Almeida,1,1,3,5,Ocasional
4016,15,5,8523.859999999999,Ana Laura Campos,4,3,4,11,VIP
4017,112,2,1560.77,Isabella Nunes,1,1,1,3,Inativo
4018,120,4,2328.83,Sr. Antônio Rocha,1,2,2,5,Ocasional
4019,58,5,2569.2599999999998,João Vitor Gonçalves,2,3,2,7,Regular
4020,7,6,6174.48,Caroline Casa Grande,4,3,3,10,VIP
4021,11,6,5937.01,Oliver Cardoso,4,3,3,10,VIP
4022,6,5,5914.73,Sara Rezende,4,3,3,10,VIP
4023,14,5,3859.2799999999997,Maria Cirino,4,3,2,9,Regular
4024,35,5,2740.32,Matteo Novais,3,3,2,8,Regular
4025,263,4,6634.34,Mirella Barros,1,2,3,6,Ocasional
4026,74,6,3633.5299999999997,Luigi Vieira,2,3,2,7,Regular
4027,8,5,8781.31,Thales da Paz,4,3,4,11,VIP
4028,139,2,798.12,Vitor Campos,1,1,1,3,Inativo
4029,173,3,5103.14,Emanuella Vargas,1,1,3,5,Ocasional
4030,33,5,6973.31,Samuel Vargas,3,3,3,9,Regular
4031,18,1,241.85,Ísis Aragão,4,1,1,6,Ocasional
4032,97,5,7135.92,Stephany da Costa,1,3,3,7,Regular
4033,12,8,13360.92,Sr. Vitor Hugo Monteiro,4,4,4,12,VIP
4034,24,4,2801.1299999999997,Danilo Macedo,3,2,2,7,Regular
4035,279,1,910.33,Dra. Agatha da Paz,1,1,1,3,Inativo
4036,10,6,5288.5,Danilo Aragão,4,3,3,10,VIP
4037,102,10,18585.96,Luan Cirino,1,4,4,9,Regular
4038,182,5,19158.48,Kamilly Cardoso,1,3,4,8,Regular
4039,280,2,1404.8400000000001,Daniela Correia,1,1,1,3,Inativo
4040,8,2,5062.97,Laís Dias,4,1,3,8,Regular
4041,67,4,5074.27,Maria Cecília Alves,2,2,3,7,Regular
4042,109,2,3577.99,Maria Alice Castro,1,1,2,4,Ocasional
4043,8,6,8878.81,Sr. João Camargo,4,3,4,11,VIP
4044,22,5,5589.610000000001,Beatriz Aragão,3,3,3,9,Regular
4045,56,1,453.8,Luiz Otávio Machado,2,1,1,4,Ocasional
4046,155,3,2182.84,Maitê Correia,1,1,1,3,Inativo
4047,30,7,5259.0599999999995,Matteo Campos,3,4,3,10,VIP
4048,42,4,9608.74,Carlos Eduardo Mendes,3,2,4,9,Regular
4049,83,3,1469.1,Emanuel da Rocha,2,1,1,4,Ocasional
4050,19,4,6088.67,Ana Vitória Sousa,4,2,3,9,Regular
4051,99,2,6623.96,Dr. Liam Rezende,1,1,3,5,Ocasional
4052,37,3,815.14,Caleb Monteiro,3,1,1,5,Ocasional
4053,39,6,7258.0,Cauã Rocha,3,3,3,9,Regular
4054,204,5,9810.869999999999,Aurora Marques,1,3,4,8,Regular
4055,40,3,755.56,Joana Albuquerque,3,1,1,5,Ocasional
4056,66,4,9507.859999999999,Pedro Lucas Novaes,2,2,4,8,Regular
4057,2,4,1140.0900000000001,Kevin Ribeiro,4,2,1,7,Regular
4058,47,4,998.53,Clara Cardoso,2,2,1,5,Ocasional
4059,79,1,100.26,Joana Guerra,2,1,1,4,Ocasional
4060,4,6,14582.32,Otávio Gonçalves,4,3,4,11,VIP
4061,63,6,5911.32,Carlos Eduardo Lopes,2,3,3,8,Regular
4062,31,3,2983.24,Renan Rezende,3,1,2,6,Ocasional
4063,70,4,6268.049999999999,Alice Monteiro,2,2,3,7,Regular
4064,48,6,13923.61,Daniel Novais,2,3,4,9,Regular
4065,49,8,9944.4,Theo da Costa,2,4,4,10,VIP
4066,5,3,2415.27,Pietra Andrade,4,1,2,7,Regular
4067,46,5,2144.2200000000003,Rafaela Dias,2,3,1,6,Ocasional
4068,79,6,10632.61,Srta. Stella Duarte,2,3,4,9,Regular
4069,97,4,6951.01,Sr. Antônio Duarte,1,2,3,6,Ocasional
4070,92,3,6564.59,Daniela Gomes,1,1,3,5,Ocasional
4071,128,1,281.32,João Pedro Barbosa,1,1,1,3,Inativo
4072,6,5,10224.04,Dra. Maria Helena Cavalcanti,4,3,4,11,VIP
4073,18,8,13168.43,Dra. Ana Júlia Gonçalves,4,4,4,12,VIP
4074,26,6,5337.05,Lívia Pereira,3,3,3,9,Regular
4075,49,7,2711.43,Raquel Monteiro,2,4,2,8,Regular
4076,36,4,1247.46,Camila Lima,3,2,1,6,Ocasional
4077,88,5,9400.56,Sabrina Correia,1,3,4,8,Regular
4078,87,2,3398.4,Carlos Eduardo Rocha,2,1,2,5,Ocasional
4079,49,8,16121.41,Joana Camargo,2,4,4,10,VIP
4080,64,7,8587.64,Luísa Nunes,2,4,4,10,VIP
4081,20,2,2225.01,Dra. Rebeca Monteiro,3,1,1,5,Ocasional
4082,7,8,3731.38,Dr. Dom Câmara,4,4,2,10,VIP
4083,62,5,9095.85,Brayan da Costa,2,3,4,9,Regular
4084,302,1,1891.69,Ana Clara Cavalcanti,1,1,1,3,Inativo
4085,16,5,4187.639999999999,Srta. Emilly da Conceição,4,3,2,9,Regular
4086,68,4,2741.36,Sra. Ana Liz Vargas,2,2,2,6,Ocasional
4087,86,3,1560.53,Stella Costela,2,1,1,4,Ocasional
4088,87,2,599.7,Dra. Ester Carvalho,2,1,1,4,Ocasional
4089,25,4,3664.5899999999997,Ana Lívia Freitas,3,2,2,7,Regular
4090,129,3,1832.98,Isadora Nogueira,1,1,1,3,Inativo
4091,32,5,5847.17,Camila Brito,3,3,3,9,Regular
4092,178,3,3801.56,Dr. Leandro Alves,1,1,2,4,Ocasional
4093,46,3,3173.58,Stella Cardoso,2,1,2,5,Ocasional
4094,25,4,9191.74,Felipe Nunes,3,2,4,9,Regular
4095,45,4,7458.77,Eloah Fernandes,2,2,4,8,Regular
4096,2,7,7911.57,Lorenzo da Costa,4,4,4,12,VIP
4097,56,5,7990.389999999999,Murilo Cunha,2,3,4,9,Regular
4098,4,5,2227.17,Lucas Gabriel Fernandes,4,3,1,8,Regular
4099,2,8,18396.59,Benjamin da Conceição,4,4,4,12,VIP
4100,59,4,9803.869999999999,Hadassa Alves,2,2,4,8,Regular
4101,153,2,1151.54,Sr. Augusto Mendes,1,1,1,3,Inativo
4102,30,5,5770.71,Júlia Mendes,3,3,3,9,Regular
4103,75,5,14846.11,Apollo Farias,2,3,4,9,Regular
4104,180,2,474.06999999999994,Arthur Gabriel Pinto,1,1,1,3,Inativo
4105,55,5,9618.04,Sr. Vitor Gabriel Brito,2,3,4,9,Regular
4106,39,4,5903.049999999999,Sra. Zoe Vasconcelos,3,2,3,8,Regular
4107,117,2,1030.26,Maria Cecília Barros,1,1,1,3,Inativo
4108,148,5,2899.7799999999997,Matteo Ramos,1,3,2,6,Ocasional
4109,208,3,680.36,Bruno da Rosa,1,1,1,3,Inativo
4110,68,2,307.02,João Gabriel Lopes,2,1,1,4,Ocasional
4111,43,3,6567.69,Antônio da Rocha,3,1,3,7,Regular
4112,26,4,906.23,Dra. Maysa Ferreira,3,2,1,6,Ocasional
4113,57,4,4932.74,Miguel Lima,2,2,3,7,Regular
4114,40,4,2131.58,Sra. Luísa Sousa,3,2,1,6,Ocasional
4115,24,2,324.74,Maria Cavalcanti,3,1,1,5,Ocasional
4116,62,3,885.03,Sr. Pedro Lucas Barbosa,2,1,1,4,Ocasional
4117,20,3,3562.52,Maria Julia Correia,3,1,2,6,Ocasional
4118,222,2,608.8299999999999,Davi Pacheco,1,1,1,3,Inativo
4119,32,9,20127.32,Noah Moraes,3,4,4,11,VIP
4120,189,5,2799.7799999999997,Emilly da Cunha,1,3,2,6,Ocasional
4121,47,4,10788.99,Carolina da Mata,2,2,4,8,Regular
4122,49,3,4737.549999999999,João Felipe da Rosa,2,1,3,6,Ocasional
4123,88,3,9883.32,Nathan da Costa,1,1,4,6,Ocasional
4124,3,3,8315.33,Rhavi Gonçalves,4,1,4,9,Regular
4125,17,2,1151.24,João Guilherme Casa Grande,4,1,1,6,Ocasional
4126,19,6,7913.83,Melissa das Neves,4,3,4,11,VIP
4127,22,1,1380.12,Anna Liz Pastor,3,1,1,5,Ocasional
4128,49,5,5771.84,Sr. Daniel Machado,2,3,3,8,Regular
4129,68,3,934.2,Marcelo Rezende,2,1,1,4,Ocasional
4130,1,6,8869.1,Pietro Mendes,4,3,4,11,VIP
4131,94,5,10311.490000000002,Sr. Bryan Fonseca,1,3,4,8,Regular
4132,28,4,5415.9800000000005,Dra. Zoe Duarte,3,2,3,8,Regular
4133,146,2,1880.68,Yan da Mata,1,1,1,3,Inativo
4134,2,4,3729.0299999999997,Francisco Abreu,4,2,2,8,Regular
4135,114,4,2167.7599999999998,Sra. Caroline Moura,1,2,1,4,Ocasional
4136,150,4,2680.41,Dra. Júlia Castro,1,2,2,5,Ocasional
4137,69,7,8936.43,Ravi Lopes,2,4,4,10,VIP
4138,4,8,11208.339999999998,Maria Laura Caldeira,4,4,4,12,VIP
4139,11,8,12378.509999999998,João Lucas Mendonça,4,4,4,12,VIP
4140,148,3,3663.1000000000004,Mariane Pacheco,1,1,2,4,Ocasional
4141,2,8,12462.62,Ana Sophia Ferreira,4,4,4,12,VIP
4142,121,3,1408.1100000000001,Benjamim Mendes,1,1,1,3,Inativo
4143,10,4,12476.01,Antony Casa Grande,4,2,4,10,VIP
4144,78,4,579.97,João Lucas Pinto,2,2,1,5,Ocasional
4145,57,3,7226.35,Bárbara Campos,2,1,3,6,Ocasional
4146,36,2,1472.87,Daniela Novaes,3,1,1,5,Ocasional
4147,42,8,10649.01,Diogo Alves,3,4,4,11,VIP
4148,80,3,2177.17,Marina Ramos,2,1,1,4,Ocasional
4149,51,4,8519.53,Maria Alice Rocha,2,2,4,8,Regular
4150,31,4,1416.01,Yan Pires,3,2,1,6,Ocasional
4151,21,3,5800.93,Anna Liz Marques,3,1,3,7,Regular
4152,49,3,2701.5299999999997,Melina Pinto,2,1,2,5,Ocasional
4153,72,6,5818.59,Miguel Novais,2,3,3,8,Regular
4154,16,4,3543.68,Juliana Peixoto,4,2,2,8,Regular
4155,78,1,103.14,Zoe Gomes,2,1,1,4,Ocasional
4156,31,4,7159.099999999999,Maria Helena Dias,3,2,3,8,Regular
4157,101,3,1987.05,Diego Almeida,1,1,1,3,Inativo
4158,103,4,2840.33,Davi Luiz Peixoto,1,2,2,5,Ocasional
4159,40,3,3431.61,João Vitor Pinto,3,1,2,6,Ocasional
4160,76,4,6901.76,Benício Ribeiro,2,2,3,7,Regular
4161,59,2,1180.4099999999999,Caleb Câmara,2,1,1,4,Ocasional
4162,153,2,6753.17,Esther Borges,1,1,3,5,Ocasional
4163,35,2,3329.29,Dra. Melina Cunha,3,1,2,6,Ocasional
4164,139,4,1455.1599999999999,Carlos Eduardo Ribeiro,1,2,1,4,Ocasional
4165,28,9,19142.02,Anthony Gabriel Abreu,3,4,4,11,VIP
4166,53,5,14172.84,Ana Júlia Cavalcante,2,3,4,9,Regular
4167,5,8,3723.73,Arthur Viana,4,4,2,10,VIP
4168,34,6,10047.36,Daniel Oliveira,3,3,4,10,VIP
4169,2,3,2197.1,Thales Mendonça,4,1,1,6,Ocasional
4170,24,3,1957.43,Marcela Albuquerque,3,1,1,5,Ocasional
4171,6,2,2220.25,Theodoro Leão,4,1,1,6,Ocasional
4172,16,4,6154.889999999999,Bianca Vieira,4,2,3,9,Regular
4173,7,5,3849.37,Theo Rios,4,3,2,9,Regular
4174,31,9,13776.82,Lunna Aparecida,3,4,4,11,VIP
4175,184,3,3523.57,Diogo Souza,1,1,2,4,Ocasional
4176,12,4,8958.03,Sr. Benício Farias,4,2,4,10,VIP
4177,10,4,16923.35,Melina Aparecida,4,2,4,10,VIP
4178,80,3,683.4,Pedro Miguel Garcia,2,1,1,4,Ocasional
4179,70,2,1171.5800000000002,Dr. Eduardo Rios,2,1,1,4,Ocasional
4180,118,2,650.3299999999999,Raul Viana,1,1,1,3,Inativo
4181,26,2,499.48,Marcela Sá,3,1,1,5,Ocasional
4182,125,5,5903.71,Thiago da Paz,1,3,3,7,Regular
4183,119,1,1087.59,Raquel Cardoso,1,1,1,3,Inativo
4184,28,5,3519.71,Gustavo Albuquerque,3,3,2,8,Regular
4185,7,8,10503.77,Hellena Costa,4,4,4,12,VIP
4186,5,3,644.41,Augusto Ferreira,4,1,1,6,Ocasional
4187,37,4,6708.43,Luigi Sá,3,2,3,8,Regular
4188,29,7,5930.08,Ágatha Andrade,3,4,3,10,VIP
4189,45,6,7421.8,Eloá Silva,2,3,4,9,Regular
4190,8,5,8877.279999999999,Dr. Luiz Gustavo Pinto,4,3,4,11,VIP
4191,54,6,8214.51,Clarice Oliveira,2,3,4,9,Regular
4192,39,3,4112.54,Sr. Marcos Vinicius Moraes,3,1,2,6,Ocasional
4193,184,5,10532.720000000001,Sr. Yan Almeida,1,3,4,8,Regular
4194,59,5,3525.05,Sara Brito,2,3,2,7,Regular
4195,40,3,1364.1299999999999,Dr. Théo da Paz,3,1,1,5,Ocasional
4196,24,4,7483.01,Dr. Alexandre Santos,3,2,4,9,Regular
4197,82,3,2281.11,João Miguel da Paz,2,1,2,5,Ocasional
4198,12,5,11357.64,Ravy Albuquerque,4,3,4,11,VIP
4200,76,5,7991.97,Sophia Vasconcelos,2,3,4,9,Regular
4201,69,5,10524.78,Theodoro Duarte,2,3,4,9,Regular
4202,159,4,5448.55,Vitor Gabriel Fonseca,1,2,3,6,Ocasional
4203,330,1,236.24,Anna Liz Borges,1,1,1,3,Inativo
4204,39,5,5728.89,Bárbara Moura,3,3,3,9,Regular
4205,20,4,2494.57,Srta. Sabrina da Luz,3,2,2,7,Regular
4206,50,5,5532.52,Henrique Vargas,2,3,3,8,Regular
4207,9,8,8351.79,Julia Machado,4,4,4,12,VIP
4209,84,6,5733.96,Anna Liz Cassiano,2,3,3,8,Regular
4210,59,4,3199.5299999999997,Ana Lívia Nunes,2,2,2,6,Ocasional
4211,213,3,3554.16,Marcela Rocha,1,1,2,4,Ocasional
4212,27,4,4858.969999999999,Bárbara Freitas,3,2,3,8,Regular
4213,6,8,10247.82,Bianca Nascimento,4,4,4,12,VIP
4214,49,2,1779.02,Ana Clara Cardoso,2,1,1,4,Ocasional
4215,83,4,5902.96,Valentina Pires,2,2,3,7,Regular
4216,5,8,7491.72,Dra. Daniela Monteiro,4,4,4,12,VIP
4217,25,4,6041.78,Sophie da Rosa,3,2,3,8,Regular
4218,48,2,480.14,Luara Mendes,2,1,1,4,Ocasional
4219,24,5,1684.2,Evelyn Moura,3,3,1,7,Regular
4220,26,4,1431.05,Caleb Pereira,3,2,1,6,Ocasional
4221,202,1,542.74,Vinicius Sales,1,1,1,3,Inativo
4222,29,5,4372.16,Emanuella Montenegro,3,3,3,9,Regular
4223,310,1,574.2,Sofia Rodrigues,1,1,1,3,Inativo
4224,106,2,3864.62,Sr. Yago Rocha,1,1,2,4,Ocasional
4225,70,4,4060.12,Emanuel Pires,2,2,2,6,Ocasional
4226,7,12,12235.07,Vinícius Cunha,4,4,4,12,VIP
4227,76,4,5205.99,João Gabriel Nascimento,2,2,3,7,Regular
4228,47,6,12447.57,Dra. Catarina Gomes,2,3,4,9,Regular
4229,173,2,4803.38,Mariana Souza,1,1,3,5,Ocasional
4230,40,6,5307.87,Vinícius Monteiro,3,3,3,9,Regular
4231,32,12,15011.78,Pedro Lucas Caldeira,3,4,4,11,VIP
4232,4,4,7202.32,Dr. Vitor Hugo Porto,4,2,3,9,Regular
4233,10,1,6371.15,Rhavi Rios,4,1,3,8,Regular
4234,88,2,1305.98,Theo Nogueira,1,1,1,3,Inativo
4235,4,5,5295.44,Maria Luísa Lopes,4,3,3,10,VIP
4236,43,5,2166.15,Isis Albuquerque,3,3,1,7,Regular
4237,14,4,2861.64,Raquel Moraes,4,2,2,8,Regular
4238,8,5,2571.5699999999997,Mariana Guerra,4,3,2,9,Regular
4239,27,6,2818.12,Sra. Olivia Pimenta,3,3,2,8,Regular
4240,46,7,11671.05,Pedro Lucas Silva,2,4,4,10,VIP
4241,4,3,4443.15,Vitor Gabriel Rios,4,1,3,8,Regular
4242,69,1,431.92,Maria Sophia Lopes,2,1,1,4,Ocasional
4243,250,1,1187.15,Leonardo Costa,1,1,1,3,Inativo
4244,25,3,4343.68,Isabel Pires,3,1,2,6,Ocasional
4245,11,4,4377.32,Mathias Porto,4,2,3,9,Regular
4246,29,3,1437.8700000000001,André Aragão,3,1,1,5,Ocasional
4247,102,2,2152.35,Arthur Miguel Aragão,1,1,1,3,Inativo
4248,20,4,1507.8600000000001,Eduarda Abreu,3,2,1,6,Ocasional
4249,48,3,8359.99,Emanuel Caldeira,2,1,4,7,Regular
4250,67,5,8006.66,Yasmin Rocha,2,3,4,9,Regular
4251,80,7,13794.38,Diogo Fogaça,2,4,4,10,VIP
4252,132,3,1398.6,Joaquim das Neves,1,1,1,3,Inativo
4253,207,6,7210.7,Julia Barros,1,3,3,7,Regular
4254,131,1,318.48,Zoe Silveira,1,1,1,3,Inativo
4255,12,7,3020.66,Bernardo Rocha,4,4,2,10,VIP
4256,27,2,509.58000000000004,Murilo da Mota,3,1,1,5,Ocasional
4257,177,3,767.84,Juan Ramos,1,1,1,3,Inativo
4259,192,1,344.52,Kamilly Pinto,1,1,1,3,Inativo
4260,18,4,4636.26,Alexia Jesus,4,2,3,9,Regular
4261,48,4,4902.33,Lavínia da Rocha,2,2,3,7,Regular
4262,196,2,4856.299999999999,Davi Cardoso,1,1,3,5,Ocasional
4263,119,5,6923.46,João Miguel Moreira,1,3,3,7,Regular
4264,38,4,2093.82,Dr. Ian da Luz,3,2,1,6,Ocasional
4265,18,4,10513.630000000001,João Guilherme Araújo,4,2,4,10,VIP
4266,38,8,6019.92,Srta. Luísa Pimenta,3,4,3,10,VIP
4267,4,2,1327.15,Dra. Camila Cassiano,4,1,1,6,Ocasional
4268,108,6,4597.75,Calebe Ribeiro,1,3,3,7,Regular
4269,32,3,1505.25,Mirella Aragão,3,1,1,5,Ocasional
4270,15,5,4250.37,Srta. Maria Liz Cardoso,4,3,2,9,Regular
4271,31,6,5741.13,Davi Lucca Lima,3,3,3,9,Regular
4272,10,5,14394.68,Sophie Pinto,4,3,4,11,VIP
4273,30,6,11688.75,Esther Pinto,3,3,4,10,VIP
4274,65,5,13751.9,Cauê Rocha,2,3,4,9,Regular
4275,63,3,3029.01,Antony Brito,2,1,2,5,Ocasional
4276,39,6,6140.38,Sabrina Brito,3,3,3,9,Regular
4277,12,3,2270.22,Brayan Vieira,4,1,2,7,Regular
4278,25,8,7413.5,Maria Helena Fonseca,3,4,4,11,VIP
4279,82,3,1475.18,Mariana das Neves,2,1,1,4,Ocasional
4280,58,6,11776.76,Ana Júlia Rezende,2,3,4,9,Regular
4281,57,4,5590.01,Giovanna Cavalcante,2,2,3,7,Regular
4282,37,4,3779.3700000000003,Ester Cavalcanti,3,2,2,7,Regular
4283,154,2,502.47,Sr. José Pedro Teixeira,1,1,1,3,Inativo
4284,22,4,2267.69,Calebe das Neves,3,2,2,7,Regular
4285,111,3,1239.8899999999999,Maria Isis Cavalcanti,1,1,1,3,Inativo
4286,27,5,4772.370000000001,Ana Vitória Fogaça,3,3,3,9,Regular
4287,366,1,1460.68,Lorenzo Rocha,1,1,1,3,Inativo
4288,50,5,8961.880000000001,Caio Rezende,2,3,4,9,Regular
4289,54,7,7871.71,Sra. Maria Vitória Lima,2,4,4,10,VIP
4290,47,8,13866.98,Lucas Gabriel Aragão,2,4,4,10,VIP
4291,1,5,5055.14,Dr. Marcos Vinicius Sales,4,3,3,10,VIP
4292,17,7,7199.84,Pietra Mendes,4,4,3,11,VIP
4293,129,2,2745.5299999999997,Srta. Isabella da Cruz,1,1,2,4,Ocasional
4294,28,4,13276.86,Alícia Leão,3,2,4,9,Regular
4295,138,5,4616.950000000001,Enzo Nogueira,1,3,3,7,Regular
4296,68,3,797.96,Maria Flor Camargo,2,1,1,4,Ocasional
4297,244,1,2268.72,Pedro Marques,1,1,2,4,Ocasional
4298,99,2,3738.62,Olivia Macedo,1,1,2,4,Ocasional
4299,78,4,4856.51,Maria Julia Rocha,2,2,3,7,Regular
4300,53,8,9175.01,Hellena Almeida,2,4,4,10,VIP
4301,69,7,7546.57,Daniela da Cunha,2,4,4,10,VIP
4302,5,4,3194.74,Pietro da Cunha,4,2,2,8,Regular
4303,110,2,1347.72,Dr. Antony Camargo,1,1,1,3,Inativo
4304,21,10,7177.9800000000005,Dr. Pietro Teixeira,3,4,3,10,VIP
4305,12,5,1242.23,Lorena Pereira,4,3,1,8,Regular
4306,35,3,3784.76,Lara Rios,3,1,2,6,Ocasional
4307,132,6,1420.38,Antonella Vieira,1,3,1,5,Ocasional
4308,51,2,1189.54,Isaque Garcia,2,1,1,4,Ocasional
4309,37,4,1633.69,João Araújo,3,2,1,6,Ocasional
4310,186,2,1883.6399999999999,Ayla Santos,1,1,1,3,Inativo
4311,18,7,9714.029999999999,Ana Julia Porto,4,4,4,12,VIP
4312,89,4,4179.51,Sra. Aylla Caldeira,1,2,2,5,Ocasional
4313,116,2,4118.17,Nicolas Melo,1,1,2,4,Ocasional
4314,77,3,3558.89,José Miguel Pinto,2,1,2,5,Ocasional
4315,42,2,579.55,Arthur Gabriel da Conceição,3,1,1,5,Ocasional
4316,54,3,3944.9100000000003,Ayla Machado,2,1,2,5,Ocasional
4317,13,3,1063.23,Julia Ramos,4,1,1,6,Ocasional
4318,21,10,10193.439999999999,Arthur Miguel Barros,3,4,4,11,VIP
4319,6,8,17693.120000000003,Pedro Miguel Sá,4,4,4,12,VIP
4320,21,3,2635.16,Eloah Lima,3,1,2,6,Ocasional
4321,155,2,1742.05,José Miguel Nascimento,1,1,1,3,Inativo
4322,246,1,332.14,Dr. Nathan Pereira,1,1,1,3,Inativo
4323,29,3,2800.31,Ravy Fonseca,3,1,2,6,Ocasional
4324,200,3,2947.4,Liam Cassiano,1,1,2,4,Ocasional
4325,12,6,8486.1,Marcela Sousa,4,3,4,11,VIP
4326,21,6,16564.1,Henry Gabriel Freitas,3,3,4,10,VIP
4327,39,4,4838.1900000000005,Ana Clara das Neves,3,2,3,8,Regular
4328,144,1,281.4,Sra. Stephany Macedo,1,1,1,3,Inativo
4329,16,4,4119.62,Luiz Miguel Montenegro,4,2,2,8,Regular
4330,11,4,1317.18,Catarina Rocha,4,2,1,7,Regular
4331,5,4,10313.36,Benício Barros,4,2,4,10,VIP
4332,11,5,6867.56,João Pedro Macedo,4,3,3,10,VIP
4333,313,1,39.46,Zoe Melo,1,1,1,3,Inativo
4334,40,4,4749.9,Ana Vitória Cavalcanti,3,2,3,8,Regular
4335,48,3,7333.03,Ryan Vieira,2,1,4,7,Regular
4336,23,6,2852.93,Daniela Cavalcante,3,3,2,8,Regular
4337,34,4,2438.79,João Felipe Cardoso,3,2,2,7,Regular
4338,191,2,859.79,Ana Clara Siqueira,1,1,1,3,Inativo
4339,59,7,2771.85,Arthur Miguel Gomes,2,4,2,8,Regular
4340,4,5,5947.51,Stella Siqueira,4,3,3,10,VIP
4341,3,2,1435.9399999999998,Bianca Sá,4,1,1,6,Ocasional
4342,199,3,2377.81,Lívia Rezende,1,1,2,4,Ocasional
4343,3,6,9908.900000000001,Brayan Carvalho,4,3,4,11,VIP
4344,13,3,2623.62,Maria Isis Teixeira,4,1,2,7,Regular
4345,27,7,14831.7,Srta. Gabrielly Santos,3,4,4,11,VIP
4346,48,5,1240.31,Sofia da Paz,2,3,1,6,Ocasional
4347,128,3,6078.23,Dra. Sabrina Monteiro,1,1,3,5,Ocasional
4348,186,4,6758.27,Ana Laura da Rosa,1,2,3,6,Ocasional
4349,54,3,1795.9,Raquel Farias,2,1,1,4,Ocasional
4350,205,4,4566.95,Benício Moura,1,2,3,6,Ocasional
4351,37,10,9834.48,Davi Castro,3,4,4,11,VIP
4352,26,4,1234.73,Heitor Caldeira,3,2,1,6,Ocasional
4353,242,4,5570.25,Felipe Santos,1,2,3,6,Ocasional
4354,2,8,9293.25,Apollo Leão,4,4,4,12,VIP
4355,12,4,697.84,Aurora Novaes,4,2,1,7,Regular
4356,36,5,12208.36,Raul Pereira,3,3,4,10,VIP
4357,20,7,1742.4,Allana Barbosa,3,4,1,8,Regular
4358,17,5,7095.429999999999,Leonardo Abreu,4,3,3,10,VIP
4359,62,5,6342.469999999999,Sabrina Casa Grande,2,3,3,8,Regular
4360,111,1,689.21,Alana Lopes,1,1,1,3,Inativo
4361,94,2,4693.22,Ester Leão,1,1,3,5,Ocasional
4362,34,4,3337.04,Isabelly Andrade,3,2,2,7,Regular
4363,87,4,5525.87,Melina Costa,2,2,3,7,Regular
4364,55,2,1732.53,Lucca Nunes,2,1,1,4,Ocasional
4365,37,1,1263.47,Heloisa Ribeiro,3,1,1,5,Ocasional
4366,38,4,10742.19,Anthony Alves,3,2,4,9,Regular
4367,26,3,3639.31,Pedro Moreira,3,1,2,6,Ocasional
4368,205,1,105.85,Maria Eduarda Fonseca,1,1,1,3,Inativo
4369,62,5,3903.13,Alícia Carvalho,2,3,2,7,Regular
4370,18,4,2277.06,Alana Guerra,4,2,2,8,Regular
4371,79,4,3110.85,Dra. Elisa Gomes,2,2,2,6,Ocasional
4372,33,5,2427.96,Eduarda Ribeiro,3,3,2,8,Regular
4373,15,2,1739.37,Dr. Vitor Gabriel Souza,4,1,1,6,Ocasional
4374,270,2,4484.78,Raquel Barros,1,1,3,5,Ocasional
4375,4,5,22244.0,Caio da Cunha,4,3,4,11,VIP
4376,9,4,8754.64,Luiz Otávio Pacheco,4,2,4,10,VIP
4377,52,7,6596.25,Paulo Silveira,2,4,3,9,Regular
4378,53,3,3762.26,José Miguel Costela,2,1,2,5,Ocasional
4379,77,2,1191.7,Lorenzo Araújo,2,1,1,4,Ocasional
4380,65,6,8207.84,Alana Macedo,2,3,4,9,Regular
4381,13,7,4434.42,Dr. Guilherme Ribeiro,4,4,3,11,VIP
4382,311,1,249.94,Yago Alves,1,1,1,3,Inativo
4383,6,6,3247.81,Ana Carolina Ferreira,4,3,2,9,Regular
4384,107,1,2962.05,Maria Luiza Pinto,1,1,2,4,Ocasional
4385,200,5,1540.59,Bento Viana,1,3,1,5,Ocasional
4386,69,5,9017.74,Dr. Enzo Gabriel Farias,2,3,4,9,Regular
4387,58,8,12580.56,Josué Vieira,2,4,4,10,VIP
4388,33,6,7401.75,Vicente Ferreira,3,3,4,10,VIP
4389,218,1,494.24,Josué Cirino,1,1,1,3,Inativo
4390,20,4,9044.240000000002,Luiz Fernando Cirino,3,2,4,9,Regular
4391,250,2,2387.05,Vitor Hugo Câmara,1,1,2,4,Ocasional
4392,53,5,3081.91,Nicole Vieira,2,3,2,7,Regular
4393,164,2,1465.93,Lucas Albuquerque,1,1,1,3,Inativo
4394,11,5,2943.07,Leandro Ferreira,4,3,2,9,Regular
4395,28,3,406.66999999999996,Giovanna Novaes,3,1,1,5,Ocasional
4396,17,5,2831.09,Nicole Pinto,4,3,2,9,Regular
4397,2,5,5015.139999999999,João da Conceição,4,3,3,10,VIP
4398,45,5,4808.2,Dr. Nathan Teixeira,2,3,3,8,Regular
4399,23,5,8715.4,Maria Laura Moreira,3,3,4,10,VIP
4400,64,3,3420.2000000000003,Marina Andrade,2,1,2,5,Ocasional
4401,3,6,2980.8199999999997,Paulo Souza,4,3,2,9,Regular
4402,22,6,5855.240000000001,Henrique Barbosa,3,3,3,9,Regular
4403,5,5,5089.58,Cecília Jesus,4,3,3,10,VIP
4404,64,6,10022.26,José Miguel Martins,2,3,4,9,Regular
4405,221,2,1142.84,Dr. Oliver das Neves,1,1,1,3,Inativo
4406,76,6,1193.54,Sr. Nathan Guerra,2,3,1,6,Ocasional
4407,36,3,5312.1,Juliana Câmara,3,1,3,7,Regular
4408,229,6,14181.5,Nathan Freitas,1,3,4,8,Regular
4409,170,4,3394.0,Thomas Rodrigues,1,2,2,5,Ocasional
4410,20,7,8879.02,Pedro Azevedo,3,4,4,11,VIP
4411,82,4,1322.33,Gabriela Barros,2,2,1,5,Ocasional
4412,4,4,2529.36,Gabriela Moreira,4,2,2,8,Regular
4413,11,5,4075.7,Heloísa da Mota,4,3,2,9,Regular
4414,48,7,17823.87,Sra. Fernanda Novais,2,4,4,10,VIP
4415,36,6,19607.58,Enrico Porto,3,3,4,10,VIP
4416,6,7,2047.9299999999998,Francisco Fonseca,4,4,1,9,Regular
4417,62,8,7512.500000000001,Isaque da Cruz,2,4,4,10,VIP
4418,346,1,350.42,Alice Melo,1,1,1,3,Inativo
4419,36,4,4653.33,Srta. Isadora Pastor,3,2,3,8,Regular
4420,233,2,5895.88,Pedro Miguel Pimenta,1,1,3,5,Ocasional
4421,61,2,135.37,Francisco Viana,2,1,1,4,Ocasional
4422,57,4,5921.46,Sr. Otto Pastor,2,2,3,7,Regular
4423,28,6,13070.59,Maria Vitória Brito,3,3,4,10,VIP
4424,182,3,1928.5800000000002,Sara Novaes,1,1,1,3,Inativo
4425,212,1,102.56,Dom Novais,1,1,1,3,Inativo
4426,8,7,6340.47,Otto Cardoso,4,4,3,11,VIP
4427,30,6,4585.61,Mariana Sampaio,3,3,3,9,Regular
4428,177,2,1122.23,Lucas Porto,1,1,1,3,Inativo
4429,4,6,5143.76,Breno Sampaio,4,3,3,10,VIP
4430,42,3,1205.26,Josué Melo,3,1,1,5,Ocasional
4431,145,4,1247.83,Sra. Valentina Fonseca,1,2,1,4,Ocasional
4432,36,7,7917.4,Sophie Sampaio,3,4,4,11,VIP
4433,366,1,45.12,Ana Carolina da Paz,1,1,1,3,Inativo
4434,6,5,5346.82,Sara Porto,4,3,3,10,VIP
4435,59,4,1546.04,Ísis Barbosa,2,2,1,5,Ocasional
4436,18,4,4961.88,Enrico Pastor,4,2,3,9,Regular
4437,37,1,412.04,Emanuel Lopes,3,1,1,5,Ocasional
4438,50,6,6413.91,Ravi Abreu,2,3,3,8,Regular
4439,161,3,5161.81,Isaac Cardoso,1,1,3,5,Ocasional
4440,11,4,8090.29,Maria Fernanda Machado,4,2,4,10,VIP
4441,20,7,8255.35,Thales Rios,3,4,4,11,VIP
4442,6,11,11785.52,Larissa Camargo,4,4,4,12,VIP
4443,133,4,1006.81,Nicolas Rocha,1,2,1,4,Ocasional
4444,90,3,2274.84,Srta. Laís da Rocha,1,1,2,4,Ocasional
4445,298,4,4128.88,Mathias Pinto,1,2,2,5,Ocasional
4446,45,3,3145.75,Esther da Mata,2,1,2,5,Ocasional
4447,189,2,575.54,Luana Pereira,1,1,1,3,Inativo
4448,49,3,462.79,Dra. Bruna Moraes,2,1,1,4,Ocasional
4449,11,7,8571.43,Gael Leão,4,4,4,12,VIP
4450,21,5,4801.41,Bárbara Nunes,3,3,3,9,Regular
4451,48,4,4707.2300000000005,Giovanna Almeida,2,2,3,7,Regular
4452,12,8,12000.43,Sra. Luísa Macedo,4,4,4,12,VIP
4453,24,5,1963.19,Raquel Cardoso,3,3,1,7,Regular
4454,13,5,6819.79,Fernanda Macedo,4,3,3,10,VIP
4455,36,4,3927.58,Mirella Mendes,3,2,2,7,Regular
4456,220,1,436.45,João Gabriel Peixoto,1,1,1,3,Inativo
4457,48,5,9959.35,Dr. Dante Cardoso,2,3,4,9,Regular
4458,26,2,460.83000000000004,Lara da Rosa,3,1,1,5,Ocasional
4459,23,7,6445.6,Mathias Gomes,3,4,3,10,VIP
4460,76,2,2434.41,Valentim Vargas,2,1,2,5,Ocasional
4461,258,1,745.41,Lorenzo Pacheco,1,1,1,3,Inativo
4462,36,1,663.46,Ravi Lucca da Mota,3,1,1,5,Ocasional
4463,227,2,2099.55,Srta. Pietra Novais,1,1,1,3,Inativo
4464,16,3,2345.5,Olívia da Mota,4,1,2,7,Regular
4465,62,3,4389.7699999999995,Alana da Costa,2,1,3,6,Ocasional
4466,101,5,6533.65,Bruna Rocha,1,3,3,7,Regular
4467,60,5,1628.1,Maria Alice Alves,2,3,1,6,Ocasional
4468,3,3,4122.0599999999995,Pietra Sales,4,1,2,7,Regular
4469,19,5,8554.9,Maysa Sousa,4,3,4,11,VIP
4470,5,2,776.48,Bárbara da Costa,4,1,1,6,Ocasional
4471,18,5,5600.160000000001,Mariah da Rosa,4,3,3,10,VIP
4472,5,8,12317.62,Levi Câmara,4,4,4,12,VIP
4473,72,2,1265.94,Ravi Lucca Garcia,2,1,1,4,Ocasional
4474,17,4,2812.16,Isadora da Cunha,4,2,2,8,Regular
4475,11,5,1818.73,Luna Alves,4,3,1,8,Regular
4476,14,1,354.56,Eloá Cunha,4,1,1,6,Ocasional
4477,47,5,6227.73,Levi Porto,2,3,3,8,Regular
4478,25,4,2660.75,Ayla Rezende,3,2,2,7,Regular
4479,32,6,7536.96,Dr. Leonardo Cassiano,3,3,4,10,VIP
4480,23,3,1941.0,Dra. Emanuella Oliveira,3,1,1,5,Ocasional
4481,277,3,1616.49,Ryan da Cruz,1,1,1,3,Inativo
4482,15,2,2551.1000000000004,Dr. João Miguel Lima,4,1,2,7,Regular
4483,28,3,2974.8900000000003,Joana da Rosa,3,1,2,6,Ocasional
4484,81,6,3724.52,Kaique Rocha,2,3,2,7,Regular
4485,36,5,3628.2000000000003,Carolina Nascimento,3,3,2,8,Regular
4486,88,2,966.76,Thiago da Paz,1,1,1,3,Inativo
4487,79,7,4910.51,Ravi Rocha,2,4,3,9,Regular
4488,28,6,5969.89,Luiz Felipe Rios,3,3,3,9,Regular
4489,30,5,4515.360000000001,Marina Caldeira,3,3,3,9,Regular
4490,33,4,1530.88,Alexandre da Conceição,3,2,1,6,Ocasional
4491,97,4,10916.820000000002,João Gabriel Teixeira,1,2,4,7,Regular
4492,49,4,14999.98,Gustavo Henrique Caldeira,2,2,4,8,Regular
4493,5,6,4991.349999999999,Amanda Andrade,4,3,3,10,VIP
4494,12,4,14249.09,Cecília Alves,4,2,4,10,VIP
4495,9,4,10165.42,Dr. Luiz Felipe Siqueira,4,2,4,10,VIP
4496,34,3,3620.99,Gustavo Henrique Barbosa,3,1,2,6,Ocasional
4497,12,6,6660.9,Vinícius Albuquerque,4,3,3,10,VIP
4498,95,3,4404.57,Pedro Fonseca,1,1,3,5,Ocasional
4499,31,2,2900.58,Sra. Nina Abreu,3,1,2,6,Ocasional
4500,25,6,3204.03,Yuri Andrade,3,3,2,8,Regular
4501,6,3,7640.799999999999,Ana Julia Martins,4,1,4,9,Regular
4502,32,5,6379.469999999999,Esther Pimenta,3,3,3,9,Regular
4503,68,3,1557.62,Carlos Eduardo Oliveira,2,1,1,4,Ocasional
4504,231,3,2035.35,Miguel Mendonça,1,1,1,3,Inativo
4505,14,7,5986.25,Maria Vitória Ribeiro,4,4,3,11,VIP
4506,11,3,2004.88,Sr. Pedro Miguel Fernandes,4,1,1,6,Ocasional
4507,27,7,9673.27,Evelyn Albuquerque,3,4,4,11,VIP
4508,97,2,12336.3,Ana Clara Araújo,1,1,4,6,Ocasional
4509,166,2,94.0,Maria Flor Alves,1,1,1,3,Inativo
4510,164,4,5192.02,Mateus Sousa,1,2,3,6,Ocasional
4511,226,1,38.64,Isabela Mendonça,1,1,1,3,Inativo
4512,46,4,4147.37,Asafe Araújo,2,2,2,6,Ocasional
4513,24,5,3191.7400000000002,Yasmin Silveira,3,3,2,8,Regular
4514,118,5,4279.22,Júlia Martins,1,3,2,6,Ocasional
4515,19,4,7599.950000000001,Henry Gabriel Guerra,4,2,4,10,VIP
4516,48,6,10854.99,Henrique Souza,2,3,4,9,Regular
4517,69,6,1784.91,Alana da Paz,2,3,1,6,Ocasional
4518,44,2,967.02,Apollo Viana,2,1,1,4,Ocasional
4519,93,4,2265.38,Dr. Pietro Ferreira,1,2,2,5,Ocasional
4520,60,4,6711.03,Sr. Cauã Melo,2,2,3,7,Regular
4521,32,4,8991.07,Mathias Câmara,3,2,4,9,Regular
4522,85,5,10749.27,Mariane Sales,2,3,4,9,Regular
4523,150,4,474.46000000000004,Bento Gonçalves,1,2,1,4,Ocasional
4524,53,8,10255.269999999999,Stella Caldeira,2,4,4,10,VIP
4525,40,6,4214.2,Bryan Farias,3,3,2,8,Regular
4526,24,3,4312.16,Miguel Nascimento,3,1,2,6,Ocasional
4527,306,1,1048.15,Luiz Fernando Pereira,1,1,1,3,Inativo
4528,42,5,7588.459999999999,Luigi Cavalcanti,3,3,4,10,VIP
4529,2,4,2053.34,Maria Fernanda Borges,4,2,1,7,Regular
4530,120,5,4836.92,Isadora Ribeiro,1,3,3,7,Regular
4531,300,5,2898.99,Ana Liz Rocha,1,3,2,6,Ocasional
4532,87,3,724.74,Hellena Casa Grande,2,1,1,4,Ocasional
4533,26,4,4865.84,Ana Vitória Sampaio,3,2,3,8,Regular
4534,38,3,3618.3,Caleb Gonçalves,3,1,2,6,Ocasional
4535,18,4,3072.66,Maria Laura Aragão,4,2,2,8,Regular
4536,28,4,1295.57,João Costa,3,2,1,6,Ocasional
4537,13,1,2190.94,Sara Macedo,4,1,1,6,Ocasional
4538,5,3,3717.46,Maria Julia Casa Grande,4,1,2,7,Regular
4539,18,5,1740.59,Liz Cardoso,4,3,1,8,Regular
4540,37,5,16551.57,Erick Pacheco,3,3,4,10,VIP
4541,54,4,907.5799999999999,Daniela Garcia,2,2,1,5,Ocasional
4542,12,4,1920.3999999999999,Davi Lucca Rios,4,2,1,7,Regular
4543,120,4,6552.599999999999,Isis da Luz,1,2,3,6,Ocasional
4544,162,3,2607.5299999999997,Maria Liz Moreira,1,1,2,4,Ocasional
4545,29,3,7973.959999999999,Josué Freitas,3,1,4,8,Regular
4546,19,5,8820.39,Antônio Fogaça,4,3,4,11,VIP
4547,18,3,5340.68,Natália Moreira,4,1,3,8,Regular
4548,25,6,10605.14,Thales Nascimento,3,3,4,10,VIP
4549,77,1,529.14,José Miguel Fonseca,2,1,1,4,Ocasional
4550,10,4,3016.24,Sr. Leonardo Caldeira,4,2,2,8,Regular
4551,1,7,6852.85,Cauê Andrade,4,4,3,11,VIP
4552,36,5,8898.470000000001,Isabela Dias,3,3,4,10,VIP
4553,17,8,11283.800000000001,Pedro Miguel Mendonça,4,4,4,12,VIP
4554,7,5,2155.5,Milena da Paz,4,3,1,8,Regular
4555,98,2,1405.3899999999999,Eduarda Cavalcante,1,1,1,3,Inativo
4556,26,4,2643.58,Joaquim Martins,3,2,2,7,Regular
4557,141,4,1871.04,Vinicius Albuquerque,1,2,1,4,Ocasional
4558,69,3,3499.94,Yuri Albuquerque,2,1,2,5,Ocasional
4559,15,7,4802.5199999999995,Lucas Gabriel Correia,4,4,3,11,VIP
4560,9,7,7183.959999999999,Dra. Daniela Aragão,4,4,3,11,VIP
4561,49,3,1599.99,Eloá Cavalcante,2,1,1,4,Ocasional
4562,111,4,5328.92,Sr. Bento Machado,1,2,3,6,Ocasional
4563,34,5,2736.1800000000003,Dra. Lorena Cassiano,3,3,2,8,Regular
4564,82,6,6953.9,Gabriela Novais,2,3,3,8,Regular
4565,1,4,723.56,Srta. Isabella Fonseca,4,2,1,7,Regular
4566,28,4,7537.0,Helena Ramos,3,2,4,9,Regular
4567,16,10,8544.83,Raquel Fonseca,4,4,4,12,VIP
4568,88,4,2120.13,Dra. Ana Laura Vieira,1,2,1,4,Ocasional
4569,19,4,5927.29,Sophia Pimenta,4,2,3,9,Regular
4570,45,4,7234.7300000000005,Renan Pires,2,2,3,7,Regular
4571,249,2,3952.11,Augusto Oliveira,1,1,2,4,Ocasional
4572,40,3,5846.94,Ester Almeida,3,1,3,7,Regular
4573,59,6,4607.59,Gustavo Henrique Teixeira,2,3,3,8,Regular
4574,32,5,9062.0,Sra. Mariah Montenegro,3,3,4,10,VIP
4575,217,2,4608.8099999999995,Dra. Brenda Cardoso,1,1,3,5,Ocasional
4576,41,3,1580.3400000000001,Laura Viana,3,1,1,5,Ocasional
4577,38,5,2376.73,Matteo Rezende,3,3,2,8,Regular
4578,9,3,1789.7400000000002,Dr. Ryan Castro,4,1,1,6,Ocasional
4579,17,5,6158.599999999999,Hadassa Farias,4,3,3,10,VIP
4580,23,4,2563.27,Ana Laura Andrade,3,2,2,7,Regular
4581,29,3,1848.96,Alice da Luz,3,1,1,5,Ocasional
4582,50,4,4767.39,Pietra Ferreira,2,2,3,7,Regular
4583,149,3,3044.34,Maria Cecília Siqueira,1,1,2,4,Ocasional
4584,6,3,3798.69,Sr. Paulo Teixeira,4,1,2,7,Regular
4585,48,6,5916.03,Olívia Camargo,2,3,3,8,Regular
4586,28,6,7371.05,Julia Fernandes,3,3,4,10,VIP
4587,12,6,10861.89,Laura da Paz,4,3,4,11,VIP
4588,51,5,8606.11,Hadassa Teixeira,2,3,4,9,Regular
4589,11,4,12364.37,Maria Júlia Ramos,4,2,4,10,VIP
4590,38,7,4464.07,Lara Castro,3,4,3,10,VIP
4591,126,4,5311.379999999999,Raul Martins,1,2,3,6,Ocasional
4592,109,5,10849.720000000001,Sra. Laís Correia,1,3,4,8,Regular
4593,19,3,2369.98,Pedro Lucas Brito,4,1,2,7,Regular
4594,18,6,2924.85,Rhavi Gomes,4,3,2,9,Regular
4595,63,3,2704.8199999999997,Rafaela Marques,2,1,2,5,Ocasional
4596,24,3,1653.63,Maria Vitória Porto,3,1,1,5,Ocasional
4597,22,7,4171.1900000000005,Sr. Benício Carvalho,3,4,2,9,Regular
4598,5,5,7919.950000000001,Liz Fernandes,4,3,4,11,VIP
4599,39,4,1547.46,Oliver Moreira,3,2,1,6,Ocasional
4600,1,3,2151.51,Isabella Ferreira,4,1,1,6,Ocasional
4601,87,8,8035.27,Léo Sales,2,4,4,10,VIP
4602,10,9,10652.56,Emanuelly Sampaio,4,4,4,12,VIP
4603,98,5,6616.24,Gabriela Carvalho,1,3,3,7,Regular
4604,230,3,5461.25,Davi Lucca Moura,1,1,3,5,Ocasional
4605,41,4,4234.72,Gustavo Henrique da Mota,3,2,2,7,Regular
4606,48,2,1447.3,Brayan Santos,2,1,1,4,Ocasional
4607,36,5,13925.65,Sr. João Felipe Rocha,3,3,4,10,VIP
4608,196,3,6994.9,Maria Clara Aparecida,1,1,3,5,Ocasional
4609,38,6,8658.9,Lucas Gabriel da Paz,3,3,4,10,VIP
4610,30,4,2452.8199999999997,Augusto Teixeira,3,2,2,7,Regular
4611,95,4,3599.15,Catarina Melo,1,2,2,5,Ocasional
4612,5,4,7005.48,Heloisa Câmara,4,2,3,9,Regular
4613,49,6,19005.39,José Pedro Costela,2,3,4,9,Regular
4614,50,8,10530.01,Giovanna Costa,2,4,4,10,VIP
4615,18,5,3157.42,José Marques,4,3,2,9,Regular
4616,101,3,656.17,Manuella Viana,1,1,1,3,Inativo
4617,44,7,18082.31,Sara Vieira,2,4,4,10,VIP
4618,31,9,16681.28,Murilo da Costa,3,4,4,11,VIP
4619,151,5,6476.87,Srta. Maria Helena Teixeira,1,3,3,7,Regular
4620,51,8,11479.39,Eduardo Novaes,2,4,4,10,VIP
4621,57,4,1086.96,João Gabriel Abreu,2,2,1,5,Ocasional
4622,257,3,2614.24,Enzo Gabriel da Paz,1,1,2,4,Ocasional
4623,12,4,4468.62,Calebe Correia,4,2,3,9,Regular
4624,84,4,3569.6000000000004,Isaac Farias,2,2,2,6,Ocasional
4625,14,2,6605.219999999999,Lorenzo Garcia,4,1,3,8,Regular
4626,8,8,13224.02,Dra. Kamilly Jesus,4,4,4,12,VIP
4627,14,5,5203.72,João Guilherme Abreu,4,3,3,10,VIP
4628,2,6,3527.15,Marcos Vinicius Araújo,4,3,2,9,Regular
4629,6,3,1073.29,Ana Lívia Mendonça,4,1,1,6,Ocasional
4630,66,3,7281.79,Ísis Oliveira,2,1,3,6,Ocasional
4631,86,4,2070.7799999999997,Sra. Evelyn Montenegro,2,2,1,5,Ocasional
4633,31,10,13598.689999999999,Henrique Fernandes,3,4,4,11,VIP
4634,35,3,5707.26,Asafe Silveira,3,1,3,7,Regular
4635,15,5,6916.8,Eduardo da Cunha,4,3,3,10,VIP
4636,123,3,4960.49,Dra. Marcela Andrade,1,1,3,5,Ocasional
4637,58,5,7994.7699999999995,Daniel Fogaça,2,3,4,9,Regular
4638,44,6,8560.37,Maria Clara Viana,2,3,4,9,Regular
4639,28,4,8373.48,Sra. Manuela Novais,3,2,4,9,Regular
4640,57,4,8164.780000000001,Dr. Davi Lucca Câmara,2,2,4,8,Regular
4641,11,5,7275.14,Pedro Henrique Pereira,4,3,3,10,VIP
4642,81,4,2449.91,Sr. Carlos Eduardo da Mata,2,2,2,6,Ocasional
4643,102,4,3091.7000000000003,Catarina Rios,1,2,2,5,Ocasional
4644,108,2,9399.99,Maria Eduarda Porto,1,1,4,6,Ocasional
4645,8,6,12776.970000000001,Diego Lima,4,3,4,11,VIP
4646,61,1,301.24,Benicio Sousa,2,1,1,4,Ocasional
4647,65,5,4437.59,João Pedro Vargas,2,3,3,8,Regular
4648,51,2,4817.42,Ana Lívia da Rocha,2,1,3,6,Ocasional
4649,8,8,7525.35,Sra. Esther Vieira,4,4,4,12,VIP
4650,47,6,4649.86,Maria Clara da Costa,2,3,3,8,Regular
4651,31,4,6783.030000000001,Pedro Lucas Novaes,3,2,3,8,Regular
4653,218,3,4765.82,Arthur Miguel Caldeira,1,1,3,5,Ocasional
4654,61,4,10104.25,Davi Lucas Caldeira,2,2,4,8,Regular
4655,37,6,11075.65,José Miguel Pacheco,3,3,4,10,VIP
4656,109,3,2266.7200000000003,Sra. Emanuella Alves,1,1,2,4,Ocasional
4657,23,3,694.94,Raul Aparecida,3,1,1,5,Ocasional
4658,65,4,8480.34,Dra. Sophie Marques,2,2,4,8,Regular
4659,141,1,562.6,João Moreira,1,1,1,3,Inativo
4660,77,6,4079.04,Srta. Natália Melo,2,3,2,7,Regular
4661,273,2,725.74,Lucas Gabriel Campos,1,1,1,3,Inativo
4662,41,4,2732.25,Evelyn da Luz,3,2,2,7,Regular
4663,348,1,339.62,Sra. Ester Dias,1,1,1,3,Inativo
4664,34,1,506.53,Pedro Lucas Casa Grande,3,1,1,5,Ocasional
4665,52,2,1982.43,Ana Beatriz Sousa,2,1,1,4,Ocasional
4667,65,3,4691.21,Apollo Peixoto,2,1,3,6,Ocasional
4668,1,7,4875.2300000000005,Dra. Ester Moreira,4,4,3,11,VIP
4669,4,5,1815.94,Dr. Gael da Rosa,4,3,1,8,Regular
4670,162,3,1404.9299999999998,Sra. Maria Júlia Lopes,1,1,1,3,Inativo
4671,33,8,6257.38,Ravi Lucca Casa Grande,3,4,3,10,VIP
4672,110,2,299.1,Mirella Marques,1,1,1,3,Inativo
4673,9,3,621.38,Luiz Henrique Barros,4,1,1,6,Ocasional
4674,75,5,8505.08,Josué Vieira,2,3,4,9,Regular
4675,8,3,1575.7,Luan Siqueira,4,1,1,6,Ocasional
4676,97,4,8462.94,Brenda Borges,1,2,4,7,Regular
4677,21,8,9431.74,Rhavi Gonçalves,3,4,4,11,VIP
4678,128,2,496.84,Henrique Pacheco,1,1,1,3,Inativo
4679,83,4,3444.87,Sra. Maria Almeida,2,2,2,6,Ocasional
4680,7,3,912.3199999999999,Augusto Leão,4,1,1,6,Ocasional
4681,66,5,2060.44,Leonardo Barbosa,2,3,1,6,Ocasional
4682,85,5,7164.22,Srta. Ana Cecília Macedo,2,3,3,8,Regular
4683,290,2,680.14,Giovanna Jesus,1,1,1,3,Inativo
4684,114,9,7236.5,Rael Macedo,1,4,3,8,Regular
4685,197,2,2420.01,Ana Cecília da Mota,1,1,2,4,Ocasional
4686,6,6,5054.11,Maria Ramos,4,3,3,10,VIP
4687,103,4,6219.19,Maria Júlia Andrade,1,2,3,6,Ocasional
4688,108,1,2916.93,Dr. Ravy Freitas,1,1,2,4,Ocasional
4689,15,2,401.73,Larissa Costa,4,1,1,6,Ocasional
4690,18,4,7948.61,Apollo Costela,4,2,4,10,VIP
4691,211,2,8071.9800000000005,Theodoro Cassiano,1,1,4,6,Ocasional
4692,76,5,4515.71,Nicole Ferreira,2,3,3,8,Regular
4693,48,6,7492.97,Theo Gonçalves,2,3,4,9,Regular
4694,6,6,7349.0,Sra. Ana Vitória Lopes,4,3,4,11,VIP
4695,64,6,4793.28,Luigi da Mata,2,3,3,8,Regular
4696,114,4,5586.78,Maria Alice Silveira,1,2,3,6,Ocasional
4697,188,2,5669.51,Henrique Correia,1,1,3,5,Ocasional
4698,153,5,14847.89,Laís Novais,1,3,4,8,Regular
4699,9,4,8643.34,Pedro Lucas da Conceição,4,2,4,10,VIP
4700,50,9,13106.88,Maitê Câmara,2,4,4,10,VIP
4701,8,6,6157.62,José Miguel Cirino,4,3,3,10,VIP
4702,8,6,4272.61,Sr. Guilherme da Rocha,4,3,2,9,Regular
4703,35,4,6930.28,Rebeca Guerra,3,2,3,8,Regular
4704,28,3,7289.51,Luiza Montenegro,3,1,3,7,Regular
4705,234,2,1501.85,Henrique Novais,1,1,1,3,Inativo
4706,250,2,1614.09,Maria Liz Correia,1,1,1,3,Inativo
4707,7,8,13751.130000000001,Vinícius Gonçalves,4,4,4,12,VIP
4708,17,7,5554.59,Breno Ferreira,4,4,3,11,VIP
4709,74,7,7105.37,Vinicius Sampaio,2,4,3,9,Regular
4710,43,5,4686.1900000000005,Heloisa da Costa,3,3,3,9,Regular
4711,6,6,13953.75,Dr. Caio Moraes,4,3,4,11,VIP
4712,19,4,10843.470000000001,Sra. Clara Ferreira,4,2,4,10,VIP
4713,82,7,3677.42,Sr. Benjamin Macedo,2,4,2,8,Regular
4714,11,5,8791.65,Sra. Rafaela Vieira,4,3,4,11,VIP
4715,97,5,12311.34,Ana Lívia da Mata,1,3,4,8,Regular
4716,18,7,6227.39,Heloisa Cassiano,4,4,3,11,VIP
4717,65,6,5127.18,Oliver da Rosa,2,3,3,8,Regular
4718,53,7,13626.14,Bento Teixeira,2,4,4,10,VIP
4719,72,2,3442.66,Marcos Vinicius das Neves,2,1,2,5,Ocasional
4720,100,6,11738.68,Lucas Peixoto,1,3,4,8,Regular
4721,45,2,1449.52,Pietra Mendes,2,1,1,4,Ocasional
4722,45,4,5408.68,Camila da Paz,2,2,3,7,Regular
4723,165,1,1132.15,Otto Fogaça,1,1,1,3,Inativo
4724,6,3,1467.16,Emanuelly Marques,4,1,1,6,Ocasional
4725,102,4,3647.7599999999998,Isadora Pereira,1,2,2,5,Ocasional
4726,58,5,4906.91,Fernando Rodrigues,2,3,3,8,Regular
4727,4,6,5265.71,Maria Laura Fogaça,4,3,3,10,VIP
4728,111,5,3465.18,Pietro Araújo,1,3,2,6,Ocasional
4729,40,5,2397.39,Sr. João Gabriel Rezende,3,3,2,8,Regular
4730,142,6,6340.639999999999,Felipe da Mota,1,3,3,7,Regular
4731,27,4,9562.64,Maria Isis Sampaio,3,2,4,9,Regular
4732,17,8,7212.53,Leandro Macedo,4,4,3,11,VIP
4733,136,1,271.78,Antonella Fernandes,1,1,1,3,Inativo
4734,26,7,15441.59,Antonella da Costa,3,4,4,11,VIP
4735,1,9,13296.36,Dante Gonçalves,4,4,4,12,VIP
4736,357,1,1209.59,Maria Laura Pinto,1,1,1,3,Inativo
4737,15,4,4648.11,Emilly Cardoso,4,2,3,9,Regular
4738,360,1,2486.26,Ayla Porto,1,1,2,4,Ocasional
4739,5,6,3354.56,Srta. Evelyn Dias,4,3,2,9,Regular
4740,42,7,9410.51,Isabella da Cunha,3,4,4,11,VIP
4741,59,2,1933.81,Ester Cirino,2,1,1,4,Ocasional
4742,8,6,8931.210000000001,Rael Alves,4,3,4,11,VIP
4743,222,2,1879.93,Calebe Vieira,1,1,1,3,Inativo
4744,151,3,1512.0300000000002,Luiz Fernando Duarte,1,1,1,3,Inativo
4745,28,6,1836.94,Caio Andrade,3,3,1,7,Regular
4746,2,7,8381.91,João Vitor Pacheco,4,4,4,12,VIP
4747,9,5,7275.55,Dr. Vitor Ribeiro,4,3,3,10,VIP
4748,18,1,734.35,Lucas das Neves,4,1,1,6,Ocasional
4749,24,2,1812.8000000000002,Letícia Rios,3,1,1,5,Ocasional
4750,62,7,4828.05,Davi Lucca Viana,2,4,3,9,Regular
4751,37,5,5961.4,Srta. Kamilly Carvalho,3,3,3,9,Regular
4753,6,2,2735.9300000000003,Srta. Sarah Mendes,4,1,2,7,Regular
4754,34,4,6844.35,Sofia Correia,3,2,3,8,Regular
4755,4,5,6974.25,Anna Liz Lopes,4,3,3,10,VIP
4756,163,2,211.57999999999998,André Duarte,1,1,1,3,Inativo
4757,124,2,3145.7799999999997,Heitor da Costa,1,1,2,4,Ocasional
4758,58,9,9798.12,Dante Ferreira,2,4,4,10,VIP
4759,3,7,5624.04,Srta. Maria Helena Pinto,4,4,3,11,VIP
4760,18,2,687.14,Sr. Antony Freitas,4,1,1,6,Ocasional
4761,158,5,5019.07,Cauê Sá,1,3,3,7,Regular
4762,2,6,3446.75,Luiz Otávio Pires,4,3,2,9,Regular
4763,12,8,5694.74,Maria Sophia Andrade,4,4,3,11,VIP
4764,103,2,1426.66,Felipe Vieira,1,1,1,3,Inativo
4765,8,7,7368.03,Noah da Mota,4,4,4,12,VIP
4766,85,1,776.45,Lucas Gabriel Teixeira,2,1,1,4,Ocasional
4767,82,5,2815.7,Sr. Carlos Eduardo Pires,2,3,2,7,Regular
4768,28,3,959.3199999999999,Sara Macedo,3,1,1,5,Ocasional
4769,123,4,8155.16,Maria Flor Moura,1,2,4,7,Regular
4770,8,11,18547.01,Vitória Pastor,4,4,4,12,VIP
4771,60,5,6795.53,Dra. Ana Clara Correia,2,3,3,8,Regular
4772,30,5,13237.3,Dr. Leandro Moreira,3,3,4,10,VIP
4773,293,1,377.2,Luiz Fernando Sales,1,1,1,3,Inativo
4774,18,6,13446.92,Matheus Barbosa,4,3,4,11,VIP
4775,1,4,3634.9900000000002,Davi Luiz Rodrigues,4,2,2,8,Regular
4776,3,4,7812.84,Sr. Liam Duarte,4,2,4,10,VIP
4777,20,3,3049.9199999999996,Vitor Hugo Machado,3,1,2,6,Ocasional
4778,110,2,424.46999999999997,José Miguel Caldeira,1,1,1,3,Inativo
4779,8,4,2299.9700000000003,José Sá,4,2,2,8,Regular
4780,6,4,11435.31,Davi Lucca Campos,4,2,4,10,VIP
4781,143,3,4813.18,Alexandre Barbosa,1,1,3,5,Ocasional
4782,33,5,11890.119999999999,Maitê Freitas,3,3,4,10,VIP
4783,229,3,8359.66,Mathias Montenegro,1,1,4,6,Ocasional
4784,115,5,3607.6899999999996,Ryan da Luz,1,3,2,6,Ocasional
4785,28,2,543.07,João Gabriel Castro,3,1,1,5,Ocasional
4786,4,3,1585.35,Apollo Sampaio,4,1,1,6,Ocasional
4787,9,5,15388.470000000001,Anna Liz Ferreira,4,3,4,11,VIP
4788,7,5,7109.71,Luana Pastor,4,3,3,10,VIP
4789,3,5,9034.8,Fernanda Cardoso,4,3,4,11,VIP
4790,12,3,1621.0900000000001,Antônio Cassiano,4,1,1,6,Ocasional
4791,59,6,7894.51,Sra. Clara Andrade,2,3,4,9,Regular
4792,60,7,10330.08,Cecilia Silveira,2,4,4,10,VIP
4793,9,3,4082.73,Danilo Camargo,4,1,2,7,Regular
4794,146,2,3053.04,Pietra Montenegro,1,1,2,4,Ocasional
4795,14,3,5840.31,Amanda Ribeiro,4,1,3,8,Regular
4796,154,3,4148.83,Olívia Pimenta,1,1,2,4,Ocasional
4797,17,5,5606.93,Breno Azevedo,4,3,3,10,VIP
4798,57,3,9273.31,Eloah Sampaio,2,1,4,7,Regular
4799,72,4,2463.83,Pedro Miguel Camargo,2,2,2,6,Ocasional
4800,6,3,2558.4399999999996,Calebe Azevedo,4,1,2,7,Regular
4801,65,4,3873.17,Heloisa da Costa,2,2,2,6,Ocasional
4802,9,7,9874.119999999999,Ana Vitória Lopes,4,4,4,12,VIP
4803,9,4,15944.949999999999,Raquel Aparecida,4,2,4,10,VIP
4804,52,2,2216.1,Mirella Cardoso,2,1,1,4,Ocasional
4805,5,6,13793.59,Maria Liz Albuquerque,4,3,4,11,VIP
4806,4,5,4350.08,Lucca Moraes,4,3,2,9,Regular
4807,114,3,1187.02,Manuella Alves,1,1,1,3,Inativo
4808,11,8,8355.87,Joana Pires,4,4,4,12,VIP
4809,201,6,14478.39,João Guilherme das Neves,1,3,4,8,Regular
4810,138,4,2811.86,Maria Laura Viana,1,2,2,5,Ocasional
4811,34,5,2938.51,Sra. Maysa Ramos,3,3,2,8,Regular
4812,2,4,7307.46,Sra. Maria Fernanda Sampaio,4,2,3,9,Regular
4813,18,2,5456.73,Stella Moreira,4,1,3,8,Regular
4814,13,3,4109.2300000000005,Dr. Luiz Gustavo Fernandes,4,1,2,7,Regular
4815,1,5,3677.9700000000003,Srta. Olívia Macedo,4,3,2,9,Regular
4816,11,2,2927.2799999999997,Cauã Vasconcelos,4,1,2,7,Regular
4817,27,7,7257.5,Maria Alice Garcia,3,4,3,10,VIP
4818,59,1,282.92,Elisa Duarte,2,1,1,4,Ocasional
4819,4,3,8817.28,Lorena Cassiano,4,1,4,9,Regular
4820,57,7,4565.08,Benjamim da Mota,2,4,3,9,Regular
4821,61,5,4541.16,Bento Rodrigues,2,3,3,8,Regular
4822,95,3,783.78,Pedro Lucas Cavalcante,1,1,1,3,Inativo
4823,64,4,3549.88,Evelyn Vieira,2,2,2,6,Ocasional
4824,18,3,3449.52,Maria Julia Pires,4,1,2,7,Regular
4825,105,5,5928.719999999999,João Barbosa,1,3,3,7,Regular
4826,25,8,6309.95,Maria Luiza Souza,3,4,3,10,VIP
4827,240,2,745.02,Sr. Ravi Lucca Dias,1,1,1,3,Inativo
4828,5,4,2121.19,Marina Fogaça,4,2,1,7,Regular
4829,135,3,3610.61,Ana Clara da Paz,1,1,2,4,Ocasional
4830,111,2,1778.4499999999998,Ravi Lucca da Cunha,1,1,1,3,Inativo
4831,84,1,521.61,Ana Beatriz Barros,2,1,1,4,Ocasional
4832,25,8,11814.42,Stella Araújo,3,4,4,11,VIP
4833,201,6,2425.4900000000002,Clarice Costela,1,3,2,6,Ocasional
4834,9,9,16425.940000000002,João Pedro Vieira,4,4,4,12,VIP
4835,3,6,9377.0,Maria Liz Novaes,4,3,4,11,VIP
4836,30,5,3969.2400000000002,Sra. Lunna Pires,3,3,2,8,Regular
4837,16,4,3692.91,Davi Lucca Campos,4,2,2,8,Regular
4838,28,4,9569.51,Benicio Cassiano,3,2,4,9,Regular
4839,49,3,690.0600000000001,João Costa,2,1,1,4,Ocasional
4840,30,5,7627.5599999999995,Dr. Enzo Gabriel da Costa,3,3,4,10,VIP
4841,59,2,709.97,Alexia da Rocha,2,1,1,4,Ocasional
4842,68,6,4883.36,Srta. Emanuelly Cirino,2,3,3,8,Regular
4843,5,5,8004.5,Sr. Fernando Ferreira,4,3,4,11,VIP
4844,55,6,6017.21,Diogo Cardoso,2,3,3,8,Regular
4845,58,6,10988.310000000001,Maria Julia Borges,2,3,4,9,Regular
4846,11,8,9619.949999999999,Sr. Pedro Henrique Lopes,4,4,4,12,VIP
4847,290,1,1329.92,Ravy Moraes,1,1,1,3,Inativo
4848,355,1,286.8,Stephany Guerra,1,1,1,3,Inativo
4849,58,5,5775.969999999999,Sr. Benjamim Alves,2,3,3,8,Regular
4850,26,6,4968.67,João Lucas Melo,3,3,3,9,Regular
4851,3,3,3584.25,João Casa Grande,4,1,2,7,Regular
4852,107,5,3503.31,Emanuella Pires,1,3,2,6,Ocasional
4853,152,5,10342.14,Carolina Pimenta,1,3,4,8,Regular
4854,24,6,3493.48,Olivia Cavalcanti,3,3,2,8,Regular
4856,82,4,11604.630000000001,Matteo Silveira,2,2,4,8,Regular
4857,100,6,3451.92,Joana Carvalho,1,3,2,6,Ocasional
4858,64,3,1840.29,Dr. Isaac Casa Grande,2,1,1,4,Ocasional
4859,79,4,5378.7,Isis Fonseca,2,2,3,7,Regular
4860,9,5,5040.88,Juan Pastor,4,3,3,10,VIP
4861,156,5,11066.42,Luna Cassiano,1,3,4,8,Regular
4862,35,4,3488.2,Davi Luiz Ribeiro,3,2,2,7,Regular
4863,18,10,8297.14,Murilo Farias,4,4,4,12,VIP
4864,171,3,3281.07,Sra. Maria Cecília Fogaça,1,1,2,4,Ocasional
4865,28,7,12700.68,Marcos Vinicius da Mota,3,4,4,11,VIP
4866,12,5,6620.85,Isis Cassiano,4,3,3,10,VIP
4867,273,2,2407.18,João Gabriel Casa Grande,1,1,2,4,Ocasional
4868,83,7,6834.110000000001,Pietra Correia,2,4,3,9,Regular
4869,25,6,8440.74,Arthur Gabriel Ribeiro,3,3,4,10,VIP
4870,46,4,2211.33,Renan Brito,2,2,1,5,Ocasional
4871,66,4,6845.599999999999,Srta. Laís Câmara,2,2,3,7,Regular
4872,3,5,2427.6499999999996,Luiz Fernando da Luz,4,3,2,9,Regular
4873,88,3,11347.18,Sofia Cavalcante,1,1,4,6,Ocasional
4874,62,4,1966.46,Ágatha Carvalho,2,2,1,5,Ocasional
4875,53,5,8777.84,Beatriz Sá,2,3,4,9,Regular
4876,1,4,2572.66,Sr. Otto Fernandes,4,2,2,8,Regular
4877,47,5,3727.8599999999997,Matheus Barros,2,3,2,7,Regular
4878,39,5,3885.29,Rodrigo Sá,3,3,2,8,Regular
4879,156,4,1669.8600000000001,Oliver Pereira,1,2,1,4,Ocasional
4880,201,5,6491.36,Alexandre Ribeiro,1,3,3,7,Regular
4882,2,5,5970.65,Marcos Vinicius Macedo,4,3,3,10,VIP
4883,14,4,2714.04,Danilo Pereira,4,2,2,8,Regular
4884,35,7,7285.84,José Pedro Gonçalves,3,4,3,10,VIP
4885,25,5,7225.42,Benicio da Conceição,3,3,3,9,Regular
4886,58,10,11675.98,Ana Laura Pacheco,2,4,4,10,VIP
4887,72,5,4796.16,Ana Laura Cunha,2,3,3,8,Regular
4888,94,3,1022.31,Paulo Mendonça,1,1,1,3,Inativo
4889,46,7,6249.56,Nina Jesus,2,4,3,9,Regular
4890,42,8,6076.61,Dra. Júlia da Conceição,3,4,3,10,VIP
4891,54,2,759.01,Ravi Camargo,2,1,1,4,Ocasional
4892,32,9,13889.49,Juliana Freitas,3,4,4,11,VIP
4893,252,1,2250.72,Isabela Viana,1,1,1,3,Inativo
4894,197,1,541.89,Kamilly Campos,1,1,1,3,Inativo
4895,56,3,10176.45,Srta. Julia Castro,2,1,4,7,Regular
4896,10,8,9136.0,Clara das Neves,4,4,4,12,VIP
4897,71,4,2685.4300000000003,Sr. Ryan Porto,2,2,2,6,Ocasional
4898,58,5,10261.47,Benicio Machado,2,3,4,9,Regular
4899,257,3,2317.65,Ana Gonçalves,1,1,2,4,Ocasional
4900,2,8,11503.419999999998,Bella Fonseca,4,4,4,12,VIP
4901,11,2,1471.86,Clarice Carvalho,4,1,1,6,Ocasional
4902,229,5,3987.4500000000003,André Cavalcanti,1,3,2,6,Ocasional
4903,46,10,12025.28,Benjamin Santos,2,4,4,10,VIP
4904,30,8,7975.459999999999,Thales Ferreira,3,4,4,11,VIP
4905,2,5,2006.6399999999999,Isabel Costa,4,3,1,8,Regular
4906,21,4,2514.19,Gustavo Henrique Silva,3,2,2,7,Regular
4908,29,8,5426.67,Dante Mendonça,3,4,3,10,VIP
4909,14,4,6656.38,Asafe Teixeira,4,2,3,9,Regular
4910,42,8,7985.05,Caleb Gomes,3,4,4,11,VIP
4911,66,4,11028.55,Nicole Porto,2,2,4,8,Regular
4912,79,4,4411.82,Eduardo da Costa,2,2,3,7,Regular
4913,189,3,4912.3099999999995,Maria Alice Machado,1,1,3,5,Ocasional
4914,90,5,9582.34,Esther Ferreira,1,3,4,8,Regular
4915,145,2,2021.47,Leandro Almeida,1,1,1,3,Inativo
4916,325,1,4425.79,Manuella Pinto,1,1,3,5,Ocasional
4917,64,8,8017.13,Luiz Otávio Vargas,2,4,4,10,VIP
4918,50,2,7472.09,Aurora Alves,2,1,4,7,Regular
4919,26,4,8231.68,Luiza Cunha,3,2,4,9,Regular
4920,5,6,6575.13,Eloá da Costa,4,3,3,10,VIP
4921,18,2,918.82,Luiz Otávio Rocha,4,1,1,6,Ocasional
4922,149,3,758.8100000000001,Luiz Otávio Caldeira,1,1,1,3,Inativo
4923,95,4,7072.15,Mirella Farias,1,2,3,6,Ocasional
4924,7,6,10229.41,Felipe Abreu,4,3,4,11,VIP
4925,33,2,3904.5099999999998,Rafael Cavalcanti,3,1,2,6,Ocasional
4926,15,2,4006.27,Ana Laura Monteiro,4,1,2,7,Regular
4927,4,8,11486.85,Emanuel Ferreira,4,4,4,12,VIP
4928,45,3,1326.4599999999998,Laura Leão,2,1,1,4,Ocasional
4929,100,4,14148.16,Léo Gonçalves,1,2,4,7,Regular
4930,14,2,3774.59,Ana Beatriz Pacheco,4,1,2,7,Regular
4931,29,6,9826.789999999999,Emanuella Ferreira,3,3,4,10,VIP
4932,171,5,6929.02,Maria Vitória Pacheco,1,3,3,7,Regular
4933,4,2,146.27,Sr. Miguel Martins,4,1,1,6,Ocasional
4934,37,4,2328.79,Sr. Lucas Jesus,3,2,2,7,Regular
4935,12,9,6364.7,Sr. Yago Aragão,4,4,3,11,VIP
4936,15,4,7422.0199999999995,Thiago Freitas,4,2,4,10,VIP
4937,28,2,2673.01,Elisa Alves,3,1,2,6,Ocasional
4938,25,8,7500.48,Anthony Gabriel Cavalcanti,3,4,4,11,VIP
4939,198,3,3745.14,Thomas Martins,1,1,2,4,Ocasional
4940,86,4,4178.79,Dr. Léo Sá,2,2,2,6,Ocasional
4941,94,2,893.55,Bernardo Lopes,1,1,1,3,Inativo
4942,29,5,10326.25,Luna Barros,3,3,4,10,VIP
4943,161,1,118.84,Liz Sá,1,1,1,3,Inativo
4944,11,2,968.0999999999999,Isabella Costela,4,1,1,6,Ocasional
4945,23,4,4555.9800000000005,Lorenzo Pereira,3,2,3,8,Regular
4946,278,2,177.92000000000002,Sra. Rebeca Fonseca,1,1,1,3,Inativo
4947,5,7,6890.69,Sra. Elisa Almeida,4,4,3,11,VIP
4948,17,10,12522.59,Melina Cavalcanti,4,4,4,12,VIP
4949,9,8,5998.44,Gabrielly Marques,4,4,3,11,VIP
4950,154,4,3298.42,Mariana Pastor,1,2,2,5,Ocasional
4951,7,5,1896.7400000000002,Gabrielly Garcia,4,3,1,8,Regular
4952,80,4,10355.25,Sra. Caroline Carvalho,2,2,4,8,Regular
4953,8,4,2905.88,Arthur Lopes,4,2,2,8,Regular
4954,5,10,13570.54,Luiz Gustavo Barbosa,4,4,4,12,VIP
4955,2,3,5286.59,Gabrielly Santos,4,1,3,8,Regular
4956,15,8,7114.379999999999,Juliana Pastor,4,4,3,11,VIP
4957,97,4,9081.05,Valentim Borges,1,2,4,7,Regular
4958,29,6,7729.11,Guilherme Brito,3,3,4,10,VIP
4959,6,6,3735.78,Diogo Mendonça,4,3,2,9,Regular
4960,28,6,11823.29,Ana Cecília Moraes,3,3,4,10,VIP
4961,40,5,12689.16,Leandro da Paz,3,3,4,10,VIP
4962,39,4,3726.08,Jade Pastor,3,2,2,7,Regular
4963,55,5,7370.509999999999,Allana Albuquerque,2,3,4,9,Regular
4964,32,6,4794.49,Davi Nogueira,3,3,3,9,Regular
4965,73,3,1353.97,Bento Fernandes,2,1,1,4,Ocasional
4966,51,3,3664.62,Sr. Igor Jesus,2,1,2,5,Ocasional
4967,61,3,4120.06,Dr. Nathan Cavalcanti,2,1,2,5,Ocasional
4968,52,6,9126.95,Théo Carvalho,2,3,4,9,Regular
4969,44,8,9671.59,Dra. Maitê Rios,2,4,4,10,VIP
4970,10,2,2672.8199999999997,Sra. Ana Clara Porto,4,1,2,7,Regular
4971,171,3,389.6,Lunna Alves,1,1,1,3,Inativo
4972,35,5,3081.85,Lara Sousa,3,3,2,8,Regular
4973,34,4,7528.95,Isis Viana,3,2,4,9,Regular
4974,28,6,1739.8,Matheus Duarte,3,3,1,7,Regular
4975,124,2,5589.799999999999,João Vitor Sousa,1,1,3,5,Ocasional
4976,29,11,6416.77,Heloísa Alves,3,4,3,10,VIP
4977,52,5,6856.6,Henry Gabriel Vasconcelos,2,3,3,8,Regular
4978,20,4,1054.57,Ryan Mendonça,3,2,1,6,Ocasional
4979,31,2,2642.4700000000003,José Miguel Camargo,3,1,2,6,Ocasional
4980,22,7,9576.24,Francisco da Paz,3,4,4,11,VIP
4981,83,4,5295.7300000000005,Rodrigo Ferreira,2,2,3,7,Regular
4982,14,3,2450.67,Rebeca Marques,4,1,2,7,Regular
4983,13,6,5249.45,Esther Porto,4,3,3,10,VIP
4984,33,7,6827.26,Vinícius Pereira,3,4,3,10,VIP
4985,93,3,3297.45,Stella Santos,1,1,2,4,Ocasional
4986,10,8,7348.12,Dra. Isabela da Paz,4,4,4,12,VIP
4987,14,4,3678.2200000000003,Dra. Luiza Fernandes,4,2,2,8,Regular
4988,39,6,11753.75,Melina Cardoso,3,3,4,10,VIP
4989,281,1,234.32,Arthur Gabriel Alves,1,1,1,3,Inativo
4990,10,5,4867.07,Ian Abreu,4,3,3,10,VIP
4991,17,5,12857.08,Srta. Raquel Campos,4,3,4,11,VIP
4992,132,4,3368.08,Ana Vitória Aragão,1,2,2,5,Ocasional
4993,67,5,2999.43,João Vitor Rezende,2,3,2,7,Regular
4994,166,2,4138.75,Giovanna Barros,1,1,2,4,Ocasional
4995,2,2,5391.139999999999,Cauê Nascimento,4,1,3,8,Regular
4996,50,3,1444.0700000000002,Danilo Rios,2,1,1,4,Ocasional
4997,54,1,40.35,Apollo Andrade,2,1,1,4,Ocasional
4998,1,8,6356.32,Isabela Novaes,4,4,3,11,VIP
4999,115,2,2847.56,Felipe Caldeira,1,1,2,4,Ocasional
5000,142,3,3254.66,Catarina Farias,1,1,2,4,Ocasional
5001,300,2,7417.33,Srta. Ana Júlia Cassiano,1,1,4,6,Ocasional
5002,71,5,5968.0,Laís Novais,2,3,3,8,Regular
5003,24,5,3314.1000000000004,Maitê Sá,3,3,2,8,Regular
5004,177,4,6742.46,Ana Júlia Costela,1,2,3,6,Ocasional
5005,36,5,4067.87,Pedro Henrique Lima,3,3,2,8,Regular
5006,26,4,1225.85,Thales da Rosa,3,2,1,6,Ocasional
5007,11,1,181.21,Enzo Gabriel Sales,4,1,1,6,Ocasional
5008,138,3,2037.1399999999999,Ana Júlia Garcia,1,1,1,3,Inativo
5009,40,6,6394.33,Raquel Câmara,3,3,3,9,Regular
5010,54,6,2781.04,Léo Cirino,2,3,2,7,Regular
5011,54,6,5087.92,José Pedro Cunha,2,3,3,8,Regular
5012,14,6,5467.030000000001,Lucca Moura,4,3,3,10,VIP
5013,10,7,4568.92,Dr. Rodrigo da Luz,4,4,3,11,VIP
5014,47,2,2123.83,Kevin Cunha,2,1,1,4,Ocasional
5015,15,7,11506.02,Vitória Duarte,4,4,4,12,VIP
5016,31,6,7454.71,Thomas Caldeira,3,3,4,10,VIP
5017,24,4,1941.46,Joana Freitas,3,2,1,6,Ocasional
5018,84,5,5053.54,Daniela Martins,2,3,3,8,Regular
5019,105,3,1484.22,Maria Eduarda Pimenta,1,1,1,3,Inativo
5020,93,4,2341.13,Asafe Nunes,1,2,2,5,Ocasional
5021,172,2,674.84,Kamilly Vieira,1,1,1,3,Inativo
5022,42,4,3169.37,Sr. Mathias Nunes,3,2,2,7,Regular
5023,75,8,6849.66,Arthur Gabriel Sá,2,4,3,9,Regular
5024,25,7,6346.43,Ana Laura Novaes,3,4,3,10,VIP
5025,19,6,4716.049999999999,Oliver Oliveira,4,3,3,10,VIP
5026,70,1,798.45,Bryan Aparecida,2,1,1,4,Ocasional
5027,114,4,3977.1,Benício Moraes,1,2,2,5,Ocasional
5028,30,2,3505.44,Alexandre Moura,3,1,2,6,Ocasional
5029,18,5,1615.51,Davi Miguel Cardoso,4,3,1,8,Regular
5030,52,7,18067.75,Srta. Camila Barbosa,2,4,4,10,VIP
5031,178,1,1271.72,André Viana,1,1,1,3,Inativo
5032,138,3,5509.62,Leandro Barros,1,1,3,5,Ocasional
5033,19,4,3492.66,Sr. Mateus da Cunha,4,2,2,8,Regular
5034,13,6,9160.31,Ryan Almeida,4,3,4,11,VIP
5035,138,4,1179.15,Sra. Eduarda Silva,1,2,1,4,Ocasional
5036,6,4,3771.35,Manuella Pinto,4,2,2,8,Regular
5037,52,7,14075.47,Sr. Ian Camargo,2,4,4,10,VIP
5038,51,4,6374.34,Alexandre Cassiano,2,2,3,7,Regular
5039,33,7,2929.53,Isaac Caldeira,3,4,2,9,Regular
5040,4,5,9092.49,Thomas Souza,4,3,4,11,VIP
5041,35,3,3532.63,Pedro da Conceição,3,1,2,6,Ocasional
5042,6,4,4127.01,Emanuel Vieira,4,2,2,8,Regular
5043,171,4,2565.68,Sra. Camila Leão,1,2,2,5,Ocasional
5044,92,1,169.28,Bárbara da Cruz,1,1,1,3,Inativo
5045,47,6,5155.82,Erick Moreira,2,3,3,8,Regular
5046,56,7,11437.880000000001,Dr. Vitor Pires,2,4,4,10,VIP
5047,31,2,345.36,Ana Liz Correia,3,1,1,5,Ocasional
5048,50,6,8118.92,Dr. Luiz Henrique Costa,2,3,4,9,Regular
5049,55,3,3371.5099999999998,Dr. Oliver Moraes,2,1,2,5,Ocasional
5050,40,4,5060.95,Clarice Rios,3,2,3,8,Regular
5051,36,5,5472.31,Nina Porto,3,3,3,9,Regular
5052,75,4,1545.92,Carlos Eduardo das Neves,2,2,1,5,Ocasional
5053,107,2,933.9300000000001,Bernardo Fogaça,1,1,1,3,Inativo
5054,45,3,2984.44,Sra. Maitê Andrade,2,1,2,5,Ocasional
5055,47,7,6347.85,Cecilia Campos,2,4,3,9,Regular
5056,217,2,2704.2799999999997,Juan Câmara,1,1,2,4,Ocasional
5057,15,5,6071.29,Lívia Gonçalves,4,3,3,10,VIP
5058,23,7,4270.57,Emanuella Garcia,3,4,2,9,Regular
5059,9,3,5965.91,Leonardo da Cruz,4,1,3,8,Regular
5060,84,4,5163.64,Cauê da Mata,2,2,3,7,Regular
5061,21,5,4791.17,Jade Siqueira,3,3,3,9,Regular
5062,76,7,10417.150000000001,Noah Monteiro,2,4,4,10,VIP
5063,180,4,4572.1900000000005,Joana da Cruz,1,2,3,6,Ocasional
5064,75,2,3716.8999999999996,Natália Nunes,2,1,2,5,Ocasional
5065,32,8,5511.740000000001,Dom Campos,3,4,3,10,VIP
5066,52,3,7749.03,Melissa Moura,2,1,4,7,Regular
5067,40,4,6872.46,Ísis Garcia,3,2,3,8,Regular
5068,10,10,16547.47,Sr. Anthony Andrade,4,4,4,12,VIP
5069,39,1,1438.69,Léo Guerra,3,1,1,5,Ocasional
5070,113,3,2982.19,Leonardo Fonseca,1,1,2,4,Ocasional
5071,24,6,5124.87,Marcela Campos,3,3,3,9,Regular
5072,6,5,5666.09,Felipe Campos,4,3,3,10,VIP
5073,71,6,6152.8099999999995,Olívia Azevedo,2,3,3,8,Regular
5074,10,5,7949.08,Antonella Araújo,4,3,4,11,VIP
5075,36,5,14135.36,Gael Henrique Rocha,3,3,4,10,VIP
5076,101,6,13638.67,Yan Leão,1,3,4,8,Regular
5077,17,3,6215.75,Maysa Vieira,4,1,3,8,Regular
5078,39,3,4857.389999999999,Bella Rodrigues,3,1,3,7,Regular
5079,9,6,7701.67,Bruno Leão,4,3,4,11,VIP
5080,167,2,143.99,Dra. Luiza das Neves,1,1,1,3,Inativo
5081,11,9,9574.439999999999,Dra. Alexia Silva,4,4,4,12,VIP
5083,97,3,2060.4700000000003,Isabella Pinto,1,1,1,3,Inativo
5084,4,4,2516.6,Leandro Costa,4,2,2,8,Regular
5085,122,4,2939.38,Rebeca Melo,1,2,2,5,Ocasional
5086,342,1,417.8,Guilherme Sá,1,1,1,3,Inativo
5087,122,2,1171.74,Dr. Thiago Garcia,1,1,1,3,Inativo
5088,21,4,536.54,Mariane Lima,3,2,1,6,Ocasional
5089,120,8,4534.55,Otto Moraes,1,4,3,8,Regular
5090,70,6,4234.52,Theo da Mata,2,3,2,7,Regular
5091,27,4,2924.43,Gael Henrique Nunes,3,2,2,7,Regular
5092,112,5,6917.51,Ana Julia Abreu,1,3,3,7,Regular
5093,18,7,9889.55,Camila Pastor,4,4,4,12,VIP
5094,11,5,5138.63,Cauê Pimenta,4,3,3,10,VIP
5095,4,3,1538.55,Ravi Lucca Sousa,4,1,1,6,Ocasional
5096,1,5,4516.96,Luiza Souza,4,3,3,10,VIP
5097,46,4,4111.87,Heloisa Cavalcante,2,2,2,6,Ocasional
5098,120,1,1429.74,Breno Costela,1,1,1,3,Inativo
5099,33,5,1421.22,Dra. Rebeca Rocha,3,3,1,7,Regular
5100,31,2,2701.52,Sr. Caleb Moreira,3,1,2,6,Ocasional
5101,213,2,4196.63,Eloá Melo,1,1,2,4,Ocasional
5102,31,8,9713.99,Srta. Laura Campos,3,4,4,11,VIP
5103,48,2,538.8,Luana Pastor,2,1,1,4,Ocasional
5104,27,5,4361.16,Luara da Rosa,3,3,2,8,Regular
5105,18,3,4380.41,Davi Lucas Farias,4,1,3,8,Regular
5106,83,4,7618.3099999999995,Luigi Azevedo,2,2,4,8,Regular
5107,36,3,2920.1,Luna Sales,3,1,2,6,Ocasional
5108,15,8,14037.34,Rhavi Mendonça,4,4,4,12,VIP
5109,60,2,1933.4099999999999,Isadora da Luz,2,1,1,4,Ocasional
5110,140,4,353.88,Melissa Leão,1,2,1,4,Ocasional
5111,186,2,3022.4,Isaac Pereira,1,1,2,4,Ocasional
5112,59,6,15273.470000000001,José Costa,2,3,4,9,Regular
5113,36,5,2826.58,João Guilherme Andrade,3,3,2,8,Regular
5114,152,3,2683.23,Fernanda Rodrigues,1,1,2,4,Ocasional
5115,18,3,2430.0299999999997,Maria Cecília Brito,4,1,2,7,Regular
5116,211,6,13341.1,Dr. Luiz Henrique Martins,1,3,4,8,Regular
5117,163,5,6805.03,Ana Lívia Ramos,1,3,3,7,Regular
5118,109,1,308.29,Dra. Gabrielly Carvalho,1,1,1,3,Inativo
5119,140,5,5846.049999999999,Valentina da Rosa,1,3,3,7,Regular
5120,6,5,10217.73,Heloísa Aragão,4,3,4,11,VIP
5121,23,5,11565.91,Maria Fernanda Brito,3,3,4,10,VIP
5122,189,2,1350.64,Oliver Sales,1,1,1,3,Inativo
5123,29,6,12182.32,Kevin Vargas,3,3,4,10,VIP
5124,30,4,1406.33,Melissa Jesus,3,2,1,6,Ocasional
5125,27,5,4275.6,Ana Lívia da Mota,3,3,2,8,Regular
5126,9,6,3341.72,Liz Novais,4,3,2,9,Regular
5127,19,4,13339.11,Leonardo Aragão,4,2,4,10,VIP
5128,62,5,5183.66,Joaquim Mendonça,2,3,3,8,Regular
5129,287,1,584.72,Maysa Campos,1,1,1,3,Inativo
5130,65,7,7638.63,Laís Siqueira,2,4,4,10,VIP
5131,19,5,3070.25,Vitor Hugo Vargas,4,3,2,9,Regular
5132,260,3,689.33,Samuel Rodrigues,1,1,1,3,Inativo
5133,225,1,283.62,Sra. Maria Julia Barros,1,1,1,3,Inativo
5134,29,4,9436.66,João Guilherme Ferreira,3,2,4,9,Regular
5135,34,7,6433.74,Pedro Miguel Moraes,3,4,3,10,VIP
5136,26,3,3504.92,Evelyn Sales,3,1,2,6,Ocasional
5137,77,5,14403.05,Alexia Abreu,2,3,4,9,Regular
5138,128,3,1836.29,Sr. Pedro Miguel Montenegro,1,1,1,3,Inativo
5139,2,7,7448.110000000001,Otávio Fernandes,4,4,4,12,VIP
5140,11,7,9526.25,Evelyn Sampaio,4,4,4,12,VIP
5141,39,2,1209.63,Sarah Melo,3,1,1,5,Ocasional
5143,3,4,3575.35,Gustavo Almeida,4,2,2,8,Regular
5144,58,3,3516.63,Breno Carvalho,2,1,2,5,Ocasional
5145,4,2,610.74,João Lucas Dias,4,1,1,6,Ocasional
5146,36,5,11398.67,José Mendonça,3,3,4,10,VIP
5147,30,2,979.84,Bento Aragão,3,1,1,5,Ocasional
5148,126,2,2687.77,Isabella Peixoto,1,1,2,4,Ocasional
5149,10,4,6051.5199999999995,Heloisa Sá,4,2,3,9,Regular
5150,43,4,4231.73,Sophie Costela,3,2,2,7,Regular
5151,12,4,2866.2000000000003,Giovanna Novais,4,2,2,8,Regular
5152,92,2,418.59000000000003,Isabela Mendes,1,1,1,3,Inativo
5153,6,8,10150.77,Marcos Vinicius Moreira,4,4,4,12,VIP
5154,27,2,3745.63,Daniela Silveira,3,1,2,6,Ocasional
5155,305,1,3508.29,Maria Luiza Macedo,1,1,2,4,Ocasional
5156,12,4,9325.09,Vitor Azevedo,4,2,4,10,VIP
5158,80,2,2421.9100000000003,Isaac da Costa,2,1,2,5,Ocasional
5159,53,5,1715.46,Zoe da Mota,2,3,1,6,Ocasional
5160,11,5,7634.110000000001,Murilo da Costa,4,3,4,11,VIP
5161,35,4,6344.379999999999,Miguel Ribeiro,3,2,3,8,Regular
5162,108,5,7542.97,Sr. Apollo Pacheco,1,3,4,8,Regular
5163,159,4,1390.87,Luara Sales,1,2,1,4,Ocasional
5164,13,3,2800.9700000000003,Srta. Manuella Silveira,4,1,2,7,Regular
5165,98,3,2364.33,Matteo Brito,1,1,2,4,Ocasional
5166,37,8,16662.18,Sra. Lorena Garcia,3,4,4,11,VIP
5167,112,3,2132.44,Davi Luiz Marques,1,1,1,3,Inativo
5168,20,6,6024.37,Vitor Gabriel Sales,3,3,3,9,Regular
5169,150,3,1092.87,Alexia Camargo,1,1,1,3,Inativo
5170,71,5,6961.97,Apollo Guerra,2,3,3,8,Regular
5171,28,4,2054.05,Diego da Luz,3,2,1,6,Ocasional
5172,175,1,129.78,Vitor Gabriel Pimenta,1,1,1,3,Inativo
5173,24,5,7991.219999999999,Fernanda Costela,3,3,4,10,VIP
5174,247,3,6268.620000000001,Alice Ferreira,1,1,3,5,Ocasional
5175,182,4,9716.039999999999,Noah Camargo,1,2,4,7,Regular
5176,70,2,2894.8900000000003,Esther Alves,2,1,2,5,Ocasional
5177,18,4,5030.21,Sr. Yago Macedo,4,2,3,9,Regular
5178,26,4,3069.37,Laura Araújo,3,2,2,7,Regular
5179,119,6,7600.570000000001,Esther Souza,1,3,4,8,Regular
5180,186,2,2534.52,Dr. Luan da Luz,1,1,2,4,Ocasional
5181,68,4,4829.93,Maria das Neves,2,2,3,7,Regular
5182,78,5,5162.22,Thomas Marques,2,3,3,8,Regular
5183,32,4,6793.77,Srta. Maria Fernanda Gonçalves,3,2,3,8,Regular
5184,43,4,1975.86,Henry Farias,3,2,1,6,Ocasional
5185,32,3,2588.1400000000003,Sr. Luiz Fernando Pinto,3,1,2,6,Ocasional
5186,62,9,5931.469999999999,Hadassa Melo,2,4,3,9,Regular
5187,47,2,8467.34,Ana Cecília Santos,2,1,4,7,Regular
5188,29,7,7305.4800000000005,Mariana Viana,3,4,3,10,VIP
5189,2,5,2004.04,Benicio Cardoso,4,3,1,8,Regular
5190,146,6,3318.07,Bianca Viana,1,3,2,6,Ocasional
5191,27,6,8020.27,Josué Mendonça,3,3,4,10,VIP
5192,53,4,4748.87,Melina da Luz,2,2,3,7,Regular
5193,10,7,6411.280000000001,Lucas Gabriel Novaes,4,4,3,11,VIP
5194,189,3,7121.7,Srta. Ísis Camargo,1,1,3,5,Ocasional
5195,94,8,12726.460000000001,Dra. Lívia Marques,1,4,4,9,Regular
5196,114,2,3801.93,Srta. Larissa Moura,1,1,2,4,Ocasional
5197,29,8,3164.2799999999997,Manuela da Cunha,3,4,2,9,Regular
5198,22,3,2155.54,Miguel Gonçalves,3,1,1,5,Ocasional
5199,63,4,1286.57,Maria Liz Câmara,2,2,1,5,Ocasional
5200,43,7,16911.93,Ian da Mota,3,4,4,11,VIP
5201,24,4,9289.61,Thomas das Neves,3,2,4,9,Regular
5202,31,2,66.45,Helena Silva,3,1,1,5,Ocasional
5203,19,5,8681.11,Gabriela Barbosa,4,3,4,11,VIP
5204,32,5,4357.83,Lavínia Melo,3,3,2,8,Regular
5205,72,2,1536.12,Daniel Mendes,2,1,1,4,Ocasional
5207,239,2,2293.28,Lorena Machado,1,1,2,4,Ocasional
5208,31,4,1125.14,Sra. Manuella Jesus,3,2,1,6,Ocasional
5209,8,3,1256.15,João Vitor da Luz,4,1,1,6,Ocasional
5210,41,5,4095.79,Sr. Davi Lucas da Rocha,3,3,2,8,Regular
5211,1,4,5222.98,Paulo Vargas,4,2,3,9,Regular
5213,214,3,4082.96,Bianca Garcia,1,1,2,4,Ocasional
5214,110,2,2833.17,Júlia Abreu,1,1,2,4,Ocasional
5215,49,9,9179.730000000001,Brenda Oliveira,2,4,4,10,VIP
5216,121,5,7740.14,Luiz Henrique Duarte,1,3,4,8,Regular
5217,10,4,3382.6099999999997,Mariane Silveira,4,2,2,8,Regular
5218,14,4,6437.22,Ágatha das Neves,4,2,3,9,Regular
5219,5,5,11048.960000000001,Ana Beatriz Marques,4,3,4,11,VIP
5220,17,7,12601.04,André Garcia,4,4,4,12,VIP
5221,39,7,6779.75,Antonella Moraes,3,4,3,10,VIP
5222,31,6,6319.84,Isabella Silva,3,3,3,9,Regular
5223,26,4,1779.35,Luna Araújo,3,2,1,6,Ocasional
5225,11,8,9884.05,Sr. Ravi Lucca Correia,4,4,4,12,VIP
5226,92,4,2894.6500000000005,Ana Liz Porto,1,2,2,5,Ocasional
5227,66,5,7593.31,Sra. Aurora da Luz,2,3,4,9,Regular
5228,126,2,1297.56,Guilherme Lopes,1,1,1,3,Inativo
5229,24,9,11032.52,Paulo Aparecida,3,4,4,11,VIP
5230,70,4,809.78,Luiz Miguel Martins,2,2,1,5,Ocasional
5231,110,4,4698.89,Eloah Cassiano,1,2,3,6,Ocasional
5232,4,5,3118.68,Dr. Luiz Otávio Dias,4,3,2,9,Regular
5233,10,5,2420.8199999999997,Maria Luísa Lima,4,3,2,9,Regular
5234,17,3,5938.09,Joaquim Câmara,4,1,3,8,Regular
5235,68,3,3510.75,Hadassa Vieira,2,1,2,5,Ocasional
5236,12,8,3634.6,Davi Lucas Fonseca,4,4,2,10,VIP
5237,44,7,6110.4400000000005,Srta. Maitê Cavalcanti,2,4,3,9,Regular
5238,75,6,9504.7,Alícia Viana,2,3,4,9,Regular
5239,62,5,2383.23,Dr. Lorenzo Leão,2,3,2,7,Regular
5241,8,3,3515.1099999999997,Sophie Câmara,4,1,2,7,Regular
5242,18,7,6550.81,Nicolas da Conceição,4,4,3,11,VIP
5243,39,3,2649.56,Renan Caldeira,3,1,2,6,Ocasional
5244,4,3,7985.49,Ana Beatriz Vargas,4,1,4,9,Regular
5246,108,3,8064.37,Ana Cecília Costela,1,1,4,6,Ocasional
5247,2,11,9553.630000000001,Dr. Bryan Nunes,4,4,4,12,VIP
5248,28,2,1631.54,Rafael Novais,3,1,1,5,Ocasional
5249,48,4,5480.34,Antônio Rocha,2,2,3,7,Regular
5250,134,4,3567.96,Rodrigo Sampaio,1,2,2,5,Ocasional
5251,23,7,5120.27,Camila Pires,3,4,3,10,VIP
5252,5,5,2058.52,Dra. Alexia Andrade,4,3,1,8,Regular
5253,39,3,2708.8199999999997,Helena Machado,3,1,2,6,Ocasional
5254,40,5,5480.0199999999995,Maria Liz Jesus,3,3,3,9,Regular
5255,10,5,11743.95,Elisa Azevedo,4,3,4,11,VIP
5256,47,2,1821.79,Gabrielly Viana,2,1,1,4,Ocasional
5257,68,2,7223.96,Dr. Thales Azevedo,2,1,3,6,Ocasional
5258,28,5,4910.89,Yago Pacheco,3,3,3,9,Regular
5259,30,4,5416.05,Enrico Correia,3,2,3,8,Regular
5260,54,2,387.03,Dra. Marina Aparecida,2,1,1,4,Ocasional
5261,4,6,3347.34,Danilo Dias,4,3,2,9,Regular
5262,18,6,7816.9,Sr. Bruno Santos,4,3,4,11,VIP
5263,47,3,3580.49,Oliver da Cunha,2,1,2,5,Ocasional
5264,40,4,5528.06,Srta. Emanuelly da Paz,3,2,3,8,Regular
5265,2,4,4923.49,Rafael da Paz,4,2,3,9,Regular
5266,147,3,3687.88,Marina Montenegro,1,1,2,4,Ocasional
5267,55,3,6680.92,Maria Julia Campos,2,1,3,6,Ocasional
5268,6,3,3883.17,Alice Pereira,4,1,2,7,Regular
5269,7,5,11124.18,Ravy Fernandes,4,3,4,11,VIP
5270,24,6,12393.32,Isaque Monteiro,3,3,4,10,VIP
5271,41,5,6285.92,Manuella Novaes,3,3,3,9,Regular
5272,39,2,5914.88,Danilo Duarte,3,1,3,7,Regular
5273,7,6,7895.62,Maria Vitória da Mata,4,3,4,11,VIP
5274,136,2,645.61,Sr. Oliver Montenegro,1,1,1,3,Inativo
5275,11,3,2091.58,Caio Freitas,4,1,1,6,Ocasional
5276,28,4,4362.12,Dante da Cruz,3,2,2,7,Regular
5277,21,3,3137.72,Murilo das Neves,3,1,2,6,Ocasional
5278,190,1,1237.26,Théo Sá,1,1,1,3,Inativo
5279,223,2,392.9,Srta. Melissa Teixeira,1,1,1,3,Inativo
5280,19,7,3709.3,Hellena Ferreira,4,4,2,10,VIP
5281,100,2,496.44000000000005,Laura Borges,1,1,1,3,Inativo
5282,45,6,7075.86,José Pedro Marques,2,3,3,8,Regular
5283,1,1,301.28,Alícia Correia,4,1,1,6,Ocasional
5284,193,2,2092.31,Noah da Rosa,1,1,1,3,Inativo
5285,96,2,2278.0499999999997,Levi da Paz,1,1,2,4,Ocasional
5286,14,4,2001.4199999999998,Pietra Pires,4,2,1,7,Regular
5287,45,7,11906.43,Igor Costela,2,4,4,10,VIP
5288,22,5,2277.79,Oliver Rios,3,3,2,8,Regular
5289,228,1,475.07,Vitor Hugo Fogaça,1,1,1,3,Inativo
5290,83,4,2216.27,Yago da Paz,2,2,1,5,Ocasional
5291,2,3,1272.34,Dr. Brayan das Neves,4,1,1,6,Ocasional
5292,12,7,4698.9400000000005,Eloá Pinto,4,4,3,11,VIP
5293,29,3,1133.3899999999999,Lívia Vieira,3,1,1,5,Ocasional
5295,19,9,9580.6,Cecilia da Conceição,4,4,4,12,VIP
5296,35,4,1617.92,Augusto Vieira,3,2,1,6,Ocasional
5297,75,7,15096.06,Maria Alice Azevedo,2,4,4,10,VIP
5298,56,6,2022.83,Vitor Hugo Ribeiro,2,3,1,6,Ocasional
5299,203,4,5444.950000000001,Matteo Abreu,1,2,3,6,Ocasional
5300,108,2,733.9000000000001,Thomas Garcia,1,1,1,3,Inativo
5301,14,5,5964.43,Kaique Nunes,4,3,3,10,VIP
5302,6,4,7650.540000000001,Anna Liz Azevedo,4,2,4,10,VIP
5303,114,2,1933.76,Bryan Pacheco,1,1,1,3,Inativo
5304,36,1,404.77,Lucca Abreu,3,1,1,5,Ocasional
5305,27,3,3308.87,Pedro Lucas Brito,3,1,2,6,Ocasional
5306,122,3,2855.18,Aurora Rocha,1,1,2,4,Ocasional
5307,50,2,851.42,Dra. Luísa Camargo,2,1,1,4,Ocasional
5308,155,5,5906.07,Sra. Rafaela Silva,1,3,3,7,Regular
5309,232,5,2125.51,Dr. Davi Silva,1,3,1,5,Ocasional
5310,133,1,2596.16,Ana Sophia Campos,1,1,2,4,Ocasional
5311,148,2,867.41,Gabriel Cavalcante,1,1,1,3,Inativo
5312,246,1,1098.5,Dr. Dante Brito,1,1,1,3,Inativo
5313,252,1,352.16,Léo da Cruz,1,1,1,3,Inativo
5314,178,2,898.41,Vitor Gabriel Camargo,1,1,1,3,Inativo
5315,333,2,6808.780000000001,Maria Laura Aragão,1,1,3,5,Ocasional
5316,56,5,3420.2599999999998,Kamilly Martins,2,3,2,7,Regular
5317,33,6,8446.39,Melina Souza,3,3,4,10,VIP
5318,7,5,6943.799999999999,Ana Cirino,4,3,3,10,VIP
5319,31,2,6062.4,Leonardo Pires,3,1,3,7,Regular
5320,36,2,2519.3,Mateus Nunes,3,1,2,6,Ocasional
5321,208,4,4653.0199999999995,Antony Teixeira,1,2,3,6,Ocasional
5322,127,4,4085.83,José Pedro Caldeira,1,2,2,5,Ocasional
5323,30,3,2029.8200000000002,Maria Julia Barbosa,3,1,1,5,Ocasional
5325,34,6,7364.01,Théo Caldeira,3,3,4,10,VIP
5326,10,2,8256.09,Benjamin Duarte,4,1,4,9,Regular
5327,14,6,9322.400000000001,Maria Luísa Costa,4,3,4,11,VIP
5328,73,5,8027.3099999999995,Juan Camargo,2,3,4,9,Regular
5329,164,3,7161.040000000001,Ana Laura Sampaio,1,1,3,5,Ocasional
5330,62,3,2772.69,Maria Cecília Viana,2,1,2,5,Ocasional
5331,221,3,8480.01,Dr. Caio Castro,1,1,4,6,Ocasional
5332,17,3,1803.41,Dr. Mathias Leão,4,1,1,6,Ocasional
5333,90,3,1379.63,Thales Almeida,1,1,1,3,Inativo
5334,36,4,5945.12,Dr. Samuel Pires,3,2,3,8,Regular
5335,192,3,1527.98,Sr. Isaac Correia,1,1,1,3,Inativo
5336,19,4,2505.7900000000004,Stella Sousa,4,2,2,8,Regular
5337,40,5,6084.92,Sabrina Nogueira,3,3,3,9,Regular
5338,86,3,1524.64,Ísis Nunes,2,1,1,4,Ocasional
5339,108,5,17238.74,Manuella Novaes,1,3,4,8,Regular
5340,5,3,523.68,Dr. Yan Mendonça,4,1,1,6,Ocasional
5341,50,6,4248.08,Alana da Mata,2,3,2,7,Regular
5342,24,9,13957.3,Valentim Teixeira,3,4,4,11,VIP
5343,128,5,4857.43,Anna Liz Jesus,1,3,3,7,Regular
5344,256,3,1693.8999999999999,Noah Silva,1,1,1,3,Inativo
5345,20,6,8797.86,Ísis Siqueira,3,3,4,10,VIP
5346,123,6,3591.23,Olivia Andrade,1,3,2,6,Ocasional
5347,58,7,6729.38,Vitor Barros,2,4,3,9,Regular
5348,65,4,7295.32,Guilherme Moura,2,2,3,7,Regular
5349,76,1,885.51,João Guilherme Pinto,2,1,1,4,Ocasional
5350,32,6,2357.2200000000003,Leonardo Melo,3,3,2,8,Regular
5351,31,2,665.34,Rodrigo da Conceição,3,1,1,5,Ocasional
5352,152,4,5071.46,Leonardo Gonçalves,1,2,3,6,Ocasional
5353,200,1,2453.99,Maria Julia Novais,1,1,2,4,Ocasional
5354,46,4,4079.01,Agatha Oliveira,2,2,2,6,Ocasional
5355,189,1,144.1,Maria Fernanda Campos,1,1,1,3,Inativo
5356,4,8,12176.460000000001,Catarina Azevedo,4,4,4,12,VIP
5357,27,2,766.78,Manuela Freitas,3,1,1,5,Ocasional
5358,172,3,8081.23,Isabela Aparecida,1,1,4,6,Ocasional
5359,16,3,1224.15,Luiza Nogueira,4,1,1,6,Ocasional
5360,2,9,6823.9,Ian Ramos,4,4,3,11,VIP
5361,43,3,677.49,Helena Cassiano,3,1,1,5,Ocasional
5362,24,7,12384.32,Maria Clara Leão,3,4,4,11,VIP
5363,24,2,347.98,João Guilherme Camargo,3,1,1,5,Ocasional
5364,36,4,2556.86,Laura Lopes,3,2,2,7,Regular
5365,68,4,4039.9399999999996,Dra. Emanuelly da Mota,2,2,2,6,Ocasional
5366,10,4,1751.02,Maria Cecília Borges,4,2,1,7,Regular
5367,40,2,787.1099999999999,Rafaela Moura,3,1,1,5,Ocasional
5368,31,6,815.9200000000001,Raquel Macedo,3,3,1,7,Regular
5369,6,6,4981.09,Gael Azevedo,4,3,3,10,VIP
5370,85,4,626.9399999999999,Ágatha Montenegro,2,2,1,5,Ocasional
5371,23,6,3984.3,Srta. Lunna Melo,3,3,2,8,Regular
5372,42,5,6282.369999999999,Vitor Silveira,3,3,3,9,Regular
5373,4,2,2885.8399999999997,Igor Silva,4,1,2,7,Regular
5375,35,2,2244.99,Luiz Fernando Nunes,3,1,1,5,Ocasional
5376,159,3,7237.380000000001,Francisco Gomes,1,1,3,5,Ocasional
5377,47,4,4578.29,Dra. Maria Cecília Silva,2,2,3,7,Regular
5378,44,5,8180.76,Fernando Castro,2,3,4,9,Regular
5379,36,5,7212.47,Diego Barros,3,3,3,9,Regular
5380,17,3,4922.64,Dr. Ryan da Cruz,4,1,3,8,Regular
5381,90,3,1040.72,Ana Luiza Novaes,1,1,1,3,Inativo
5382,19,5,5049.16,Alexia Moura,4,3,3,10,VIP
5383,11,5,7383.9,Luara Moraes,4,3,4,11,VIP
5384,32,8,8531.51,Cecília da Luz,3,4,4,11,VIP
5385,28,7,10924.98,Ana Liz Garcia,3,4,4,11,VIP
5386,85,4,3323.6800000000003,Otávio da Rocha,2,2,2,6,Ocasional
5387,59,6,3687.62,Isabelly Barros,2,3,2,7,Regular
5388,19,7,8879.519999999999,Raul das Neves,4,4,4,12,VIP
5389,1,1,1211.82,Fernando Sá,4,1,1,6,Ocasional
5390,30,7,9274.66,Luan da Rocha,3,4,4,11,VIP
5391,6,3,1046.92,Milena Monteiro,4,1,1,6,Ocasional
5392,311,1,321.77,Pedro Alves,1,1,1,3,Inativo
5393,283,1,462.57,Vitor das Neves,1,1,1,3,Inativo
5394,90,2,2139.45,Davi Miguel Cunha,1,1,1,3,Inativo
5395,148,5,12148.619999999999,Isabela Araújo,1,3,4,8,Regular
5396,5,1,1825.21,Luigi Pereira,4,1,1,6,Ocasional
5397,21,6,12857.84,Dom Fogaça,3,3,4,10,VIP
5398,10,4,6040.5,Antônio Mendes,4,2,3,9,Regular
5399,282,1,455.18,Raul Monteiro,1,1,1,3,Inativo
5400,308,1,757.76,Ana Lívia Caldeira,1,1,1,3,Inativo
5401,35,7,9950.78,Davi Lucca da Rosa,3,4,4,11,VIP
5402,53,3,1975.8899999999999,Laura Freitas,2,1,1,4,Ocasional
5403,36,4,1099.8899999999999,Dr. Davi Luiz Garcia,3,2,1,6,Ocasional
5404,102,2,788.1800000000001,Daniela Gomes,1,1,1,3,Inativo
5405,57,4,5063.75,Valentim Novaes,2,2,3,7,Regular
5406,21,5,11746.07,Marcos Vinicius Rezende,3,3,4,10,VIP
5407,10,6,5058.34,Lucas Gabriel Viana,4,3,3,10,VIP
5408,10,6,1335.28,André Aparecida,4,3,1,8,Regular
5409,19,5,11925.36,Isabela Oliveira,4,3,4,11,VIP
5410,28,6,6310.3,Bruna Albuquerque,3,3,3,9,Regular
5411,60,2,1535.19,Sr. Davi Mendonça,2,1,1,4,Ocasional
5412,147,5,1750.64,Sarah Fonseca,1,3,1,5,Ocasional
5413,216,4,3383.08,Isaque Ferreira,1,2,2,5,Ocasional
5414,39,2,1184.12,Davi Lucas Sousa,3,1,1,5,Ocasional
5415,28,8,14436.230000000001,Jade Vasconcelos,3,4,4,11,VIP
5416,23,6,4876.7300000000005,Jade Jesus,3,3,3,9,Regular
5417,1,4,3721.3,Daniel Cunha,4,2,2,8,Regular
5418,17,2,2350.66,Thiago Cavalcanti,4,1,2,7,Regular
5419,48,4,9613.39,Diego Costela,2,2,4,8,Regular
5420,55,5,5683.74,Maria Luiza Freitas,2,3,3,8,Regular
5421,72,2,7100.07,Antony Ferreira,2,1,3,6,Ocasional
5422,22,8,15916.48,Isabella Pinto,3,4,4,11,VIP
5424,40,5,3724.6099999999997,Rafaela Freitas,3,3,2,8,Regular
5426,11,4,3741.59,Luiza Almeida,4,2,2,8,Regular
5427,55,6,9931.86,Letícia Caldeira,2,3,4,9,Regular
5428,97,6,13110.970000000001,Ravy Machado,1,3,4,8,Regular
5429,149,1,223.68,Murilo Aparecida,1,1,1,3,Inativo
5430,97,7,14545.52,Ana Carolina Nascimento,1,4,4,9,Regular
5431,355,1,675.22,Dra. Agatha Lopes,1,1,1,3,Inativo
5432,21,9,17597.92,Dr. Nathan Brito,3,4,4,11,VIP
5433,68,7,8276.51,Luara Montenegro,2,4,4,10,VIP
5434,4,2,2619.14,Gael Henrique Sales,4,1,2,7,Regular
5435,240,2,867.33,Aylla Moreira,1,1,1,3,Inativo
5436,6,9,9009.91,Liam Ribeiro,4,4,4,12,VIP
5437,7,5,17573.11,Daniela Fernandes,4,3,4,11,VIP
5438,19,8,13910.27,Dra. Natália Freitas,4,4,4,12,VIP
5439,1,8,13665.03,Thiago Moreira,4,4,4,12,VIP
5440,22,3,7399.89,Pedro Lucas Silveira,3,1,4,8,Regular
5441,89,5,9008.53,Esther Carvalho,1,3,4,8,Regular
5442,36,3,2878.0699999999997,André Câmara,3,1,2,6,Ocasional
5443,25,3,2978.4700000000003,Dr. José Pedro Caldeira,3,1,2,6,Ocasional
5444,37,4,8945.55,Arthur Sá,3,2,4,9,Regular
5445,68,9,6745.75,João Guilherme Novaes,2,4,3,9,Regular
5446,49,3,2777.72,Elisa Caldeira,2,1,2,5,Ocasional
5447,17,5,5518.219999999999,Mariah da Paz,4,3,3,10,VIP
5448,28,3,7908.820000000001,Sr. Gustavo Gonçalves,3,1,4,8,Regular
5449,239,2,3027.96,Srta. Ester Sampaio,1,1,2,4,Ocasional
5450,46,6,5573.9,Ravy Nascimento,2,3,3,8,Regular
5451,48,7,2347.1899999999996,Matheus Siqueira,2,4,2,8,Regular
5452,5,2,7204.91,Mariana Sampaio,4,1,3,8,Regular
5453,6,5,9105.17,Dr. Samuel Lopes,4,3,4,11,VIP
5454,6,9,7986.28,Sra. Valentina Carvalho,4,4,4,12,VIP
5455,29,7,10098.57,Larissa Sales,3,4,4,11,VIP
5456,93,3,4230.29,Ana Júlia Machado,1,1,2,4,Ocasional
5457,36,1,2418.44,Giovanna Carvalho,3,1,2,6,Ocasional
5458,132,2,215.75,Thomas Moura,1,1,1,3,Inativo
5459,32,4,3643.2299999999996,Benjamin Moraes,3,2,2,7,Regular
5460,34,4,5755.24,Dra. Alexia Leão,3,2,3,8,Regular
5461,2,5,3329.03,Juan Pinto,4,3,2,9,Regular
5462,27,5,4161.55,Vitor Hugo Souza,3,3,2,8,Regular
5463,7,1,1466.37,Luara Pacheco,4,1,1,6,Ocasional
5464,21,5,4114.55,Cecília Pires,3,3,2,8,Regular
5465,67,5,13284.179999999998,Sabrina Araújo,2,3,4,9,Regular
5466,158,6,8794.87,Benício Rocha,1,3,4,8,Regular
5467,45,5,6288.55,Dra. Eduarda Silva,2,3,3,8,Regular
5468,95,5,6075.43,Miguel Andrade,1,3,3,7,Regular
5469,3,7,5708.65,Caleb Mendes,4,4,3,11,VIP
5470,69,4,2804.7200000000003,Josué Costela,2,2,2,6,Ocasional
5471,72,3,1433.8799999999999,Evelyn Alves,2,1,1,4,Ocasional
5472,16,6,3314.5899999999997,Benjamim Machado,4,3,2,9,Regular
5473,121,1,886.98,Noah Fonseca,1,1,1,3,Inativo
5474,5,9,8589.71,Pietra Mendonça,4,4,4,12,VIP
5475,46,1,1184.62,Yan Lopes,2,1,1,4,Ocasional
5476,36,4,2198.38,Luiz Fernando Sousa,3,2,1,6,Ocasional
5477,91,5,5316.82,Maria Luiza Fonseca,1,3,3,7,Regular
5478,6,4,7385.49,Bella Cavalcanti,4,2,4,10,VIP
5479,8,6,4030.78,Srta. Beatriz Oliveira,4,3,2,9,Regular
5480,54,2,553.97,Clarice Ribeiro,2,1,1,4,Ocasional
5481,59,5,4594.120000000001,Bárbara Camargo,2,3,3,8,Regular
5482,58,5,5672.54,Alexandre Alves,2,3,3,8,Regular
5483,11,8,7721.35,Eloá da Mata,4,4,4,12,VIP
5484,41,2,3917.37,Maya Albuquerque,3,1,2,6,Ocasional
5485,37,3,840.98,Isaac da Conceição,3,1,1,5,Ocasional
5486,44,4,2158.7200000000003,Eloah Silva,2,2,1,5,Ocasional
5487,15,7,20051.59,Srta. Isis Caldeira,4,4,4,12,VIP
5488,32,3,2795.5399999999995,Breno Nascimento,3,1,2,6,Ocasional
5489,7,4,2838.44,Ryan Abreu,4,2,2,8,Regular
5490,74,3,3637.06,Srta. Helena Carvalho,2,1,2,5,Ocasional
5491,1,2,581.44,Sophie Souza,4,1,1,6,Ocasional
5492,2,7,20862.09,Raquel Nogueira,4,4,4,12,VIP
5493,12,6,3794.74,Mariana das Neves,4,3,2,9,Regular
5494,58,3,7510.71,Ana Beatriz Gomes,2,1,4,7,Regular
5495,13,3,7193.36,Vitor Gabriel Sá,4,1,3,8,Regular
5496,21,3,2684.9500000000003,Yan Rezende,3,1,2,6,Ocasional
5497,29,7,4744.83,Sra. Milena Alves,3,4,3,10,VIP
5498,68,3,5505.869999999999,Francisco Alves,2,1,3,6,Ocasional
5499,4,6,10340.95,João Miguel Moreira,4,3,4,11,VIP
5500,10,6,11596.87,Isabela Abreu,4,3,4,11,VIP
5501,165,2,2973.51,Renan Ramos,1,1,2,4,Ocasional
5502,13,3,2318.05,Luiz Henrique Cavalcanti,4,1,2,7,Regular
5503,17,4,3974.88,Anna Liz Cunha,4,2,2,8,Regular
5504,349,1,4409.71,Sr. Antônio Albuquerque,1,1,3,5,Ocasional
5505,30,6,2542.09,Sophie Moura,3,3,2,8,Regular
5506,43,5,4203.09,Felipe Cavalcante,3,3,2,8,Regular
5507,7,5,4209.0599999999995,Yasmin Caldeira,4,3,2,9,Regular
5508,228,4,3929.9100000000003,Mateus Albuquerque,1,2,2,5,Ocasional
5509,5,6,5658.29,Thomas Leão,4,3,3,10,VIP
5510,58,5,11160.79,Cauã Vasconcelos,2,3,4,9,Regular
5511,60,4,3172.1199999999994,Rebeca da Cruz,2,2,2,6,Ocasional
5512,55,3,4491.73,Mariane Montenegro,2,1,3,6,Ocasional
5513,88,3,7678.03,Mariane Pires,1,1,4,6,Ocasional
5514,68,4,6554.02,Dr. Ryan Barros,2,2,3,7,Regular
5515,124,5,2236.28,Ana Julia da Conceição,1,3,1,5,Ocasional
5516,51,7,5673.25,Emanuelly Costa,2,4,3,9,Regular
5517,65,4,7120.719999999999,Isadora Camargo,2,2,3,7,Regular
5518,168,2,370.25,Daniel Sampaio,1,1,1,3,Inativo
5519,14,7,6904.2,Lívia Campos,4,4,3,11,VIP
5520,32,8,13176.5,Caio Cunha,3,4,4,11,VIP
5521,2,1,1248.16,Danilo Caldeira,4,1,1,6,Ocasional
5522,151,2,7323.08,Emanuel Gomes,1,1,4,6,Ocasional
5523,160,6,6302.81,Luísa Duarte,1,3,3,7,Regular
5524,34,6,2819.77,Heitor da Mata,3,3,2,8,Regular
5525,34,4,10876.91,Ana Clara Pereira,3,2,4,9,Regular
5526,47,3,1319.4,Srta. Esther Correia,2,1,1,4,Ocasional
5527,25,3,3326.38,Isaac Santos,3,1,2,6,Ocasional
5528,24,6,15970.630000000001,Lara Almeida,3,3,4,10,VIP
5529,86,4,12308.699999999999,Maria Flor Freitas,2,2,4,8,Regular
5530,49,4,10394.480000000001,Theo da Rocha,2,2,4,8,Regular
5531,17,8,10307.67,Sra. Maria Isis Siqueira,4,4,4,12,VIP
5532,209,1,688.33,Stella Novaes,1,1,1,3,Inativo
5533,21,2,116.50999999999999,Nicole Aparecida,3,1,1,5,Ocasional
5534,265,2,2053.9,Erick Duarte,1,1,1,3,Inativo
5535,96,1,2420.2,Beatriz Fonseca,1,1,2,4,Ocasional
5536,11,9,9140.64,Allana Araújo,4,4,4,12,VIP
5537,163,4,2782.47,Kaique Ferreira,1,2,2,5,Ocasional
5538,97,5,2425.71,Allana Azevedo,1,3,2,6,Ocasional
5539,60,6,10604.84,Eloá Rezende,2,3,4,9,Regular
5540,75,4,6467.88,Srta. Ana Julia Marques,2,2,3,7,Regular
5541,126,3,3190.95,Letícia Cirino,1,1,2,4,Ocasional
5542,34,1,34.59,Sr. Cauã Cardoso,3,1,1,5,Ocasional
5543,26,12,17697.68,Mariah Sousa,3,4,4,11,VIP
5544,29,5,4568.26,Gustavo Pereira,3,3,3,9,Regular
5545,12,10,4718.84,Emanuella Leão,4,4,3,11,VIP
5546,57,7,7613.99,Dr. Davi Luiz Machado,2,4,4,10,VIP
5547,44,4,3163.75,Ana Laura Aragão,2,2,2,6,Ocasional
5548,87,3,2425.51,Sra. Olivia Siqueira,2,1,2,5,Ocasional
5549,34,5,1588.68,Dr. Juan Sampaio,3,3,1,7,Regular
5550,18,9,9455.65,Joana Nogueira,4,4,4,12,VIP
5551,129,2,2434.5699999999997,Dra. Maria Vitória da Cunha,1,1,2,4,Ocasional
5552,187,6,2266.31,Enrico Brito,1,3,2,6,Ocasional
5553,7,6,12191.68,Bryan Sampaio,4,3,4,11,VIP
5554,50,3,3328.86,Felipe Caldeira,2,1,2,5,Ocasional
5555,19,3,2666.48,Liz da Mata,4,1,2,7,Regular
5556,34,5,8313.02,Milena Caldeira,3,3,4,10,VIP
5557,62,2,5429.59,Dr. João Felipe Campos,2,1,3,6,Ocasional
5558,57,3,1163.1599999999999,Francisco da Rocha,2,1,1,4,Ocasional
5559,28,4,5838.150000000001,Gael Sousa,3,2,3,8,Regular
5560,78,5,6234.5599999999995,Bernardo Dias,2,3,3,8,Regular
5561,37,3,3163.6400000000003,Mariane Pires,3,1,2,6,Ocasional
5562,38,6,13844.59,Breno Aparecida,3,3,4,10,VIP
5563,92,7,9322.269999999999,Augusto das Neves,1,4,4,9,Regular
5564,15,4,8707.23,Maria Alice Costela,4,2,4,10,VIP
5565,24,3,4561.09,Heloísa Oliveira,3,1,3,7,Regular
5566,37,4,4816.57,Ísis Almeida,3,2,3,8,Regular
5567,19,2,982.14,Dr. Heitor Oliveira,4,1,1,6,Ocasional
5568,105,8,10458.02,Laís Fernandes,1,4,4,9,Regular
5569,270,2,8409.0,Julia Rocha,1,1,4,6,Ocasional
5570,20,2,2202.56,Sra. Júlia Porto,3,1,1,5,Ocasional
5571,93,2,3611.16,Luana da Rosa,1,1,2,4,Ocasional
5572,44,1,163.19,José Miguel Cardoso,2,1,1,4,Ocasional
5573,13,4,4475.969999999999,João Gabriel da Conceição,4,2,3,9,Regular
5574,42,1,16.01,Dr. João Fonseca,3,1,1,5,Ocasional
5575,2,6,5776.02,Noah Vieira,4,3,3,10,VIP
5576,50,4,4498.43,Amanda da Costa,2,2,3,7,Regular
5577,2,5,4869.84,Danilo Peixoto,4,3,3,10,VIP
5578,301,1,479.38,Thomas Silveira,1,1,1,3,Inativo
5579,1,5,7255.62,Luna Fernandes,4,3,3,10,VIP
5580,11,5,5073.36,Oliver Carvalho,4,3,3,10,VIP
5581,218,3,3443.7799999999997,Sra. Elisa Rocha,1,1,2,4,Ocasional
5582,16,5,3929.4300000000003,João Felipe Fonseca,4,3,2,9,Regular
5583,95,1,474.15,Bernardo da Rocha,1,1,1,3,Inativo
5584,59,3,4266.83,Caio Cardoso,2,1,2,5,Ocasional
5585,22,5,5244.94,Luiz Henrique Pereira,3,3,3,9,Regular
5586,104,4,1591.07,Ester Cassiano,1,2,1,4,Ocasional
5587,42,2,618.97,Nathan Moura,3,1,1,5,Ocasional
5588,75,3,9552.49,Bento Rodrigues,2,1,4,7,Regular
5589,52,1,635.44,Nicolas Cirino,2,1,1,4,Ocasional
5590,160,2,2172.72,Sr. Benjamim Campos,1,1,1,3,Inativo
5591,4,3,3496.83,Hellena Martins,4,1,2,7,Regular
5592,269,4,5171.75,Aurora da Mata,1,2,3,6,Ocasional
5593,58,3,5775.41,Dr. Liam da Conceição,2,1,3,6,Ocasional
5594,39,7,8337.220000000001,Larissa Freitas,3,4,4,11,VIP
5595,3,6,8524.539999999999,Sarah da Paz,4,3,4,11,VIP
5596,41,3,690.61,Arthur Guerra,3,1,1,5,Ocasional
5597,61,4,3491.7599999999998,Hadassa Souza,2,2,2,6,Ocasional
5598,42,5,5402.24,Elisa Monteiro,3,3,3,9,Regular
5599,8,5,7099.27,Pedro Miguel Nunes,4,3,3,10,VIP
5600,120,3,1831.8300000000002,Beatriz Ferreira,1,1,1,3,Inativo
5601,18,4,6679.9,Larissa Porto,4,2,3,9,Regular
5602,36,5,3715.14,Nicole Mendonça,3,3,2,8,Regular
5604,158,6,3659.81,Isabela da Conceição,1,3,2,6,Ocasional
5605,241,3,3479.98,Ester Vargas,1,1,2,4,Ocasional
5606,96,4,1158.81,Lara Jesus,1,2,1,4,Ocasional
5607,43,7,15931.67,Laís da Costa,3,4,4,11,VIP
5608,34,2,985.62,Dr. Davi Miguel das Neves,3,1,1,5,Ocasional
5609,58,4,7518.35,Isadora da Mata,2,2,4,8,Regular
5610,22,5,7058.3099999999995,Stephany Costa,3,3,3,9,Regular
5611,43,2,5352.969999999999,Davi Lucca Aparecida,3,1,3,7,Regular
5612,27,3,7388.58,Dr. Pedro Henrique Brito,3,1,4,8,Regular
5613,24,2,186.54000000000002,Sr. João Vasconcelos,3,1,1,5,Ocasional
5614,94,5,3798.96,Ravi Moreira,1,3,2,6,Ocasional
5615,4,6,12998.24,Ravi Araújo,4,3,4,11,VIP
5616,83,3,1663.62,Caroline Abreu,2,1,1,4,Ocasional
5617,13,6,4805.360000000001,Danilo Silveira,4,3,3,10,VIP
5618,20,5,4708.83,Sra. Marcela da Conceição,3,3,3,9,Regular
5619,31,5,2065.93,Théo Silveira,3,3,1,7,Regular
5620,156,3,3781.77,Rael Moreira,1,1,2,4,Ocasional
5621,254,2,1872.67,Juan Marques,1,1,1,3,Inativo
5622,86,3,8331.19,Eloah Guerra,2,1,4,7,Regular
5623,27,4,3207.49,Antony Albuquerque,3,2,2,7,Regular
5624,87,5,6492.21,João Felipe Lima,2,3,3,8,Regular
5625,70,4,2327.75,Davi Lucas Moraes,2,2,2,6,Ocasional
5626,68,6,2456.13,Dom da Conceição,2,3,2,7,Regular
5627,23,7,4639.99,Ana Laura Moreira,3,4,3,10,VIP
5628,91,7,3666.6099999999997,Júlia Nogueira,1,4,2,7,Regular
5629,2,6,4037.0299999999997,Sra. Mariana Sá,4,3,2,9,Regular
5630,23,5,3056.05,Maria Liz Costa,3,3,2,8,Regular
5631,45,4,1927.04,Dra. Emanuelly Barros,2,2,1,5,Ocasional
5632,67,3,7437.929999999999,João Moreira,2,1,4,7,Regular
5633,65,4,3457.45,Milena Costa,2,2,2,6,Ocasional
5634,150,4,4567.74,Juliana Câmara,1,2,3,6,Ocasional
5635,192,3,1110.04,Isadora Abreu,1,1,1,3,Inativo
5636,97,9,14881.24,Melina Mendonça,1,4,4,9,Regular
5637,111,3,3321.82,Theodoro Cunha,1,1,2,4,Ocasional
5638,3,4,1890.27,Dra. Lavínia Viana,4,2,1,7,Regular
5639,135,4,9254.73,Eloá Martins,1,2,4,7,Regular
5640,50,3,3201.88,Maria Castro,2,1,2,5,Ocasional
5641,15,5,8763.4,Srta. Melissa Cassiano,4,3,4,11,VIP
5642,54,3,3631.79,Luísa Farias,2,1,2,5,Ocasional
5643,6,5,6095.79,Mirella Silva,4,3,3,10,VIP
5644,10,6,11164.45,Murilo Mendonça,4,3,4,11,VIP
5645,87,4,11815.539999999999,Davi Luiz Câmara,2,2,4,8,Regular
5646,151,2,4099.76,Liam Santos,1,1,2,4,Ocasional
5647,36,5,4543.49,Alexia Correia,3,3,3,9,Regular
5648,110,5,5609.9,Dra. Maria Eduarda Vieira,1,3,3,7,Regular
5649,110,2,1532.69,Sra. Nicole da Conceição,1,1,1,3,Inativo
5650,16,7,7435.7699999999995,Cecília Moreira,4,4,4,12,VIP
5651,35,2,8474.31,João Guilherme Lima,3,1,4,8,Regular
5652,92,3,4264.66,Ana Lívia Oliveira,1,1,2,4,Ocasional
5653,16,4,2256.2599999999998,Maria Luísa da Cunha,4,2,1,7,Regular
5654,5,6,5211.4,Eloah Macedo,4,3,3,10,VIP
5655,48,3,1390.0400000000002,Ana Clara Moura,2,1,1,4,Ocasional
5656,51,5,10853.62,Olívia Cirino,2,3,4,9,Regular
5657,38,4,6360.22,Ryan Vasconcelos,3,2,3,8,Regular
5658,27,7,12752.07,Isabel Nogueira,3,4,4,11,VIP
5659,72,7,10747.79,Nina Camargo,2,4,4,10,VIP
5660,22,5,5514.92,Bento Pimenta,3,3,3,9,Regular
5661,147,2,1170.81,Sofia Mendonça,1,1,1,3,Inativo
5662,74,4,5328.51,Pietra Sá,2,2,3,7,Regular
5663,6,3,7826.95,Anthony Gabriel Almeida,4,1,4,9,Regular
5664,103,3,2738.07,Nicolas Costela,1,1,2,4,Ocasional
5665,60,2,2573.06,Francisco Dias,2,1,2,5,Ocasional
5666,48,5,8744.51,Renan da Luz,2,3,4,9,Regular
5667,71,4,2692.8,Stella Monteiro,2,2,2,6,Ocasional
5668,30,4,6896.799999999999,Maria Julia Machado,3,2,3,8,Regular
5669,49,3,1307.25,Eloah Correia,2,1,1,4,Ocasional
5670,148,1,5939.35,Arthur Nogueira,1,1,3,5,Ocasional
5671,14,5,4184.860000000001,Felipe Barros,4,3,2,9,Regular
5673,57,8,12072.98,Caroline Vargas,2,4,4,10,VIP
5674,46,2,3158.89,Jade Alves,2,1,2,5,Ocasional
5675,8,5,4345.13,Augusto Nunes,4,3,2,9,Regular
5676,43,2,319.17,Maria Laura Ribeiro,3,1,1,5,Ocasional
5677,80,3,3313.99,Samuel Cavalcante,2,1,2,5,Ocasional
5678,70,3,2092.51,Yasmin da Luz,2,1,1,4,Ocasional
5679,141,2,1132.74,João Vitor Duarte,1,1,1,3,Inativo
5680,30,4,2774.7599999999998,Maitê Borges,3,2,2,7,Regular
5681,57,6,8515.0,Hadassa Sales,2,3,4,9,Regular
5682,8,6,8705.27,Olívia Cavalcante,4,3,4,11,VIP
5683,6,7,12297.31,Dante Ribeiro,4,4,4,12,VIP
5684,52,2,14011.11,Dr. Anthony Gabriel da Cruz,2,1,4,7,Regular
5685,64,4,3499.61,Maysa Cassiano,2,2,2,6,Ocasional
5686,67,8,5860.6,Luiza Barros,2,4,3,9,Regular
5687,84,6,7539.54,Letícia Albuquerque,2,3,4,9,Regular
5688,9,6,3128.04,Theo Gomes,4,3,2,9,Regular
5689,45,5,3040.44,Dr. José Alves,2,3,2,7,Regular
5690,30,4,4711.52,Dra. Lara Novais,3,2,3,8,Regular
5691,246,1,101.1,Sra. Ana Beatriz Santos,1,1,1,3,Inativo
5692,99,3,1893.9299999999998,Thomas Porto,1,1,1,3,Inativo
5693,159,6,4344.9,Isis Gonçalves,1,3,2,6,Ocasional
5694,122,2,1773.95,Maria Fernanda Pereira,1,1,1,3,Inativo
5695,30,4,9255.88,Luan Gonçalves,3,2,4,9,Regular
5696,4,9,10193.15,Otto Farias,4,4,4,12,VIP
5697,143,4,4458.09,Renan Pastor,1,2,3,6,Ocasional
5698,203,3,1252.87,Maria Luiza Farias,1,1,1,3,Inativo
5699,26,4,9583.98,Fernando Barros,3,2,4,9,Regular
5700,4,6,5022.0,Nicole Almeida,4,3,3,10,VIP
5701,27,5,2156.5,Esther das Neves,3,3,1,7,Regular
5702,13,2,668.45,Lorenzo Lima,4,1,1,6,Ocasional
5703,140,6,2334.69,Elisa Gomes,1,3,2,6,Ocasional
5704,36,4,9917.24,Rael Pastor,3,2,4,9,Regular
5705,11,5,6399.7,Lara Silva,4,3,3,10,VIP
5706,84,7,6493.18,Isaque Mendonça,2,4,3,9,Regular
5707,190,1,1843.6,Aurora da Luz,1,1,1,3,Inativo
5708,48,1,1740.51,Emanuella Souza,2,1,1,4,Ocasional
5709,175,3,4516.099999999999,Srta. Ana Beatriz Nunes,1,1,3,5,Ocasional
5710,20,3,3022.9900000000002,Otto Guerra,3,1,2,6,Ocasional
5711,110,2,628.82,Jade das Neves,1,1,1,3,Inativo
5712,94,5,4729.71,Dra. Laís Teixeira,1,3,3,7,Regular
5713,331,1,1467.1,Luiz Miguel Costa,1,1,1,3,Inativo
5714,48,4,4110.23,Maria Laura Souza,2,2,2,6,Ocasional
5715,44,2,692.54,Benicio Teixeira,2,1,1,4,Ocasional
5716,32,3,5173.02,Vitor Hugo Câmara,3,1,3,7,Regular
5717,13,4,3475.1099999999997,Calebe Cardoso,4,2,2,8,Regular
5718,361,1,3304.28,Cauã Mendonça,1,1,2,4,Ocasional
5719,17,3,4193.58,Maria Luísa Sales,4,1,2,7,Regular
5720,61,2,301.98999999999995,Evelyn Ramos,2,1,1,4,Ocasional
5721,34,3,1956.4,Dra. Maria Sophia Cunha,3,1,1,5,Ocasional
5723,59,5,3923.98,Maria Clara da Mata,2,3,2,7,Regular
5724,155,4,3060.69,Beatriz da Luz,1,2,2,5,Ocasional
5725,282,2,6001.639999999999,Olívia Abreu,1,1,3,5,Ocasional
5726,29,5,2754.02,André Andrade,3,3,2,8,Regular
5727,23,4,8025.539999999999,Vinicius da Paz,3,2,4,9,Regular
5728,109,4,2578.82,Dra. Maria Isis Casa Grande,1,2,2,5,Ocasional
5729,134,1,2239.56,Antony Ferreira,1,1,1,3,Inativo
5730,52,6,5128.35,Maria Sophia Sá,2,3,3,8,Regular
5731,50,3,3988.74,Srta. Lívia Teixeira,2,1,2,5,Ocasional
5732,2,5,2805.94,Alícia Aparecida,4,3,2,9,Regular
5733,2,3,6025.51,Luiz Miguel Fernandes,4,1,3,8,Regular
5734,85,5,7421.799999999999,Elisa Cardoso,2,3,4,9,Regular
5735,176,2,2052.16,Cecilia da Conceição,1,1,1,3,Inativo
5736,23,8,8636.130000000001,Josué Moura,3,4,4,11,VIP
5737,37,2,3267.75,Heitor Pacheco,3,1,2,6,Ocasional
5738,3,5,4215.68,Arthur Miguel Fonseca,4,3,2,9,Regular
5739,73,1,2003.97,Alícia Araújo,2,1,1,4,Ocasional
5740,65,4,3936.57,Enrico Ferreira,2,2,2,6,Ocasional
5741,77,4,3075.5,Leonardo Casa Grande,2,2,2,6,Ocasional
5742,22,6,6644.92,Sr. Nicolas Macedo,3,3,3,9,Regular
5743,7,4,8149.77,Sr. Gabriel Moraes,4,2,4,10,VIP
5744,30,4,6850.29,Henry Rios,3,2,3,8,Regular
5745,7,8,9964.689999999999,Joaquim Moreira,4,4,4,12,VIP
5746,44,3,1559.71,Maitê Porto,2,1,1,4,Ocasional
5747,22,3,3193.51,Pedro Henrique Dias,3,1,2,6,Ocasional
5748,176,2,3305.09,Luiz Felipe Rocha,1,1,2,4,Ocasional
5749,40,2,2528.98,Sr. João Felipe Rios,3,1,2,6,Ocasional
5750,9,4,2087.27,Antônio Marques,4,2,1,7,Regular
5752,81,6,6369.51,Maria Helena Caldeira,2,3,3,8,Regular
5753,104,8,4384.25,Maysa Cardoso,1,4,3,8,Regular
5754,59,3,4005.17,Luiz Henrique Teixeira,2,1,2,5,Ocasional
5755,38,4,2876.8,Ana Lívia Vasconcelos,3,2,2,7,Regular
5756,7,3,3766.38,Nathan Novaes,4,1,2,7,Regular
5757,116,5,2758.86,Josué Cavalcanti,1,3,2,6,Ocasional
5758,11,5,12250.350000000002,Maria Clara Pinto,4,3,4,11,VIP
5759,25,3,1841.29,Ana Liz Duarte,3,1,1,5,Ocasional
5760,87,2,1147.66,Benjamin Ramos,2,1,1,4,Ocasional
5761,42,3,1449.1000000000001,Zoe Monteiro,3,1,1,5,Ocasional
5762,22,4,5878.969999999999,Yan Caldeira,3,2,3,8,Regular
5763,281,4,5611.89,José Miguel Caldeira,1,2,3,6,Ocasional
5764,27,3,2232.16,Jade Sá,3,1,1,5,Ocasional
5765,241,1,235.93,Nicolas Novaes,1,1,1,3,Inativo
5766,37,3,1694.62,Catarina Vasconcelos,3,1,1,5,Ocasional
5767,39,6,12046.61,Benjamim Cavalcanti,3,3,4,10,VIP
5768,32,1,1348.1,Ana Júlia Lima,3,1,1,5,Ocasional
5769,91,4,5712.139999999999,Dra. Larissa da Cunha,1,2,3,6,Ocasional
5770,8,2,1325.31,André Teixeira,4,1,1,6,Ocasional
5771,72,6,4597.84,Antony Rodrigues,2,3,3,8,Regular
5772,23,3,7999.57,Lucca Costela,3,1,4,8,Regular
5773,93,4,1327.22,Evelyn Cavalcante,1,2,1,4,Ocasional
5774,81,4,3637.3,Joana Rezende,2,2,2,6,Ocasional
5775,19,4,2691.92,Henry Mendes,4,2,2,8,Regular
5776,34,2,2309.02,Enrico Silveira,3,1,2,6,Ocasional
5777,20,10,11628.37,Benicio Correia,3,4,4,11,VIP
5778,44,3,4047.6899999999996,Luiz Henrique Andrade,2,1,2,5,Ocasional
5779,225,1,2386.44,Lara Porto,1,1,2,4,Ocasional
5780,37,3,706.4300000000001,Pietra Nogueira,3,1,1,5,Ocasional
5781,26,5,15124.24,Maria Julia Monteiro,3,3,4,10,VIP
5782,74,8,8060.95,Ísis Moura,2,4,4,10,VIP
5783,118,4,3745.8999999999996,Ana Beatriz Pereira,1,2,2,5,Ocasional
5784,26,6,5416.23,Nicole Marques,3,3,3,9,Regular
5785,121,3,5740.18,Joana Andrade,1,1,3,5,Ocasional
5786,23,3,4249.360000000001,Rafaela Rodrigues,3,1,2,6,Ocasional
5787,13,10,10268.49,Dr. Enzo Nunes,4,4,4,12,VIP
5788,51,7,6341.67,Daniela Cassiano,2,4,3,9,Regular
5789,86,3,11041.77,Maria Luísa Sousa,2,1,4,7,Regular
5790,182,4,9585.78,Calebe das Neves,1,2,4,7,Regular
5791,14,4,4885.6,Sr. Carlos Eduardo da Paz,4,2,3,9,Regular
5792,11,1,955.43,Bryan Teixeira,4,1,1,6,Ocasional
5793,82,5,3846.11,Valentina Lopes,2,3,2,7,Regular
5794,32,2,2022.6100000000001,Isis da Cunha,3,1,1,5,Ocasional
5795,77,2,1942.87,Sra. Ana Laura Silva,2,1,1,4,Ocasional
5796,62,7,8849.58,Benício Pacheco,2,4,4,10,VIP
5797,9,4,758.95,Diego Macedo,4,2,1,7,Regular
5798,4,7,2538.77,Helena Rezende,4,4,2,10,VIP
5799,63,3,2368.64,Kamilly Câmara,2,1,2,5,Ocasional
5800,9,9,11612.24,José Miguel Guerra,4,4,4,12,VIP
5801,28,2,5885.67,Natália Cavalcanti,3,1,3,7,Regular
5802,40,5,4242.13,Maya Macedo,3,3,2,8,Regular
5803,26,2,3719.5199999999995,Lorenzo da Mota,3,1,2,6,Ocasional
5804,10,5,4181.8099999999995,Lara Nascimento,4,3,2,9,Regular
5805,43,4,1771.0,Valentim Sales,3,2,1,6,Ocasional
5806,146,4,3790.9399999999996,Sr. Theo Aparecida,1,2,2,5,Ocasional
5807,64,4,7301.08,Srta. Maria Helena Borges,2,2,3,7,Regular
5808,14,4,6770.71,Elisa Pinto,4,2,3,9,Regular
5809,82,3,2433.9700000000003,Jade Jesus,2,1,2,5,Ocasional
5810,28,6,7885.43,Maria Guerra,3,3,4,10,VIP
5811,32,9,7360.37,Valentina Pereira,3,4,4,11,VIP
5812,79,4,3679.94,Asafe da Conceição,2,2,2,6,Ocasional
5813,54,4,7476.54,Vitor Hugo Sales,2,2,4,8,Regular
5814,56,4,3511.74,Srta. Maria Júlia Nascimento,2,2,2,6,Ocasional
5815,11,2,489.5,Ana Sophia Novaes,4,1,1,6,Ocasional
5816,62,4,4073.44,Diogo Aparecida,2,2,2,6,Ocasional
5817,128,4,4007.1499999999996,Giovanna Gonçalves,1,2,2,5,Ocasional
5818,42,5,3139.82,Gustavo Henrique Araújo,3,3,2,8,Regular
5819,41,4,7646.51,Arthur da Rosa,3,2,4,9,Regular
5820,104,3,3235.46,Erick da Conceição,1,1,2,4,Ocasional
5821,31,4,6741.469999999999,Dra. Manuella Peixoto,3,2,3,8,Regular
5822,1,4,2386.48,Eduardo Alves,4,2,2,8,Regular
5823,22,5,4533.24,Juliana Silva,3,3,3,9,Regular
5824,23,5,1268.8300000000002,Henry Gabriel Pereira,3,3,1,7,Regular
5825,168,4,2355.82,Yago Casa Grande,1,2,2,5,Ocasional
5826,12,9,4891.73,Dra. Helena da Cruz,4,4,3,11,VIP
5827,215,2,1995.43,Sra. Ana Lívia da Rosa,1,1,1,3,Inativo
5828,189,1,79.45,Aurora Rios,1,1,1,3,Inativo
5829,38,5,5588.32,Laura Ribeiro,3,3,3,9,Regular
5830,51,3,3237.2400000000002,Manuela Silva,2,1,2,5,Ocasional
5831,8,4,1697.52,Ana Vitória Abreu,4,2,1,7,Regular
5832,1,5,1373.21,Letícia Sousa,4,3,1,8,Regular
5833,3,5,8870.84,André Moraes,4,3,4,11,VIP
5834,5,5,5958.509999999999,João Felipe Peixoto,4,3,3,10,VIP
5835,152,4,2757.43,Caroline Montenegro,1,2,2,5,Ocasional
5836,30,1,4167.12,Ayla Albuquerque,3,1,2,6,Ocasional
5837,3,4,2647.33,Eduardo da Rosa,4,2,2,8,Regular
5838,26,5,6565.07,Otávio Novais,3,3,3,9,Regular
5839,98,2,2619.81,Maria Vitória Borges,1,1,2,4,Ocasional
5840,68,2,1632.44,Antônio da Rosa,2,1,1,4,Ocasional
5841,111,4,2337.69,Benício Aragão,1,2,2,5,Ocasional
5842,87,3,4344.02,Danilo Mendes,2,1,2,5,Ocasional
5843,27,3,2253.3,Sophie Alves,3,1,1,5,Ocasional
5844,159,3,1694.1,Thiago da Rosa,1,1,1,3,Inativo
5845,7,4,6985.44,Antônio Moura,4,2,3,9,Regular
5846,192,3,3808.8999999999996,Dra. Jade da Rocha,1,1,2,4,Ocasional
5847,13,4,3300.96,Brayan Araújo,4,2,2,8,Regular
5848,17,5,5092.02,Liam Nogueira,4,3,3,10,VIP
5849,100,4,6895.88,Sra. Olívia Aragão,1,2,3,6,Ocasional
5850,15,3,2088.36,Henry Gabriel Fernandes,4,1,1,6,Ocasional
5851,19,6,3645.6299999999997,Dr. João Pedro Rezende,4,3,2,9,Regular
5852,4,5,3550.8100000000004,Henrique Aparecida,4,3,2,9,Regular
5853,41,4,4058.61,Pedro Cardoso,3,2,2,7,Regular
5854,169,5,8557.789999999999,Kamilly Pimenta,1,3,4,8,Regular
5855,338,2,1012.43,Gabrielly Sampaio,1,1,1,3,Inativo
5856,76,3,8292.3,Emanuel Carvalho,2,1,4,7,Regular
5857,6,7,11536.380000000001,Daniela Machado,4,4,4,12,VIP
5858,18,6,15255.42,Maria Eduarda Peixoto,4,3,4,11,VIP
5859,57,3,416.84,Rafael Pastor,2,1,1,4,Ocasional
5860,9,5,5085.9800000000005,Mariah Pires,4,3,3,10,VIP
5861,57,3,430.53999999999996,Isabella das Neves,2,1,1,4,Ocasional
5862,26,4,8502.51,Nicole Duarte,3,2,4,9,Regular
5863,10,2,403.83000000000004,Emanuel da Cunha,4,1,1,6,Ocasional
5864,70,4,5538.09,Sra. Ágatha Barros,2,2,3,7,Regular
5865,12,4,5244.56,Sra. Alice Rios,4,2,3,9,Regular
5866,43,3,1332.63,Ana Carolina Santos,3,1,1,5,Ocasional
5867,136,2,1596.13,Sophia da Rosa,1,1,1,3,Inativo
5868,23,5,7608.23,Ryan Ramos,3,3,4,10,VIP
5869,30,7,12409.45,André Ferreira,3,4,4,11,VIP
5870,24,8,7574.5,João Vitor Câmara,3,4,4,11,VIP
5871,14,6,13636.04,João Vitor Câmara,4,3,4,11,VIP
5872,190,2,1269.0300000000002,Antônio Aragão,1,1,1,3,Inativo
5873,57,1,74.14,Samuel Ferreira,2,1,1,4,Ocasional
5874,94,6,8743.71,João Pedro da Conceição,1,3,4,8,Regular
5875,20,3,4189.040000000001,Théo Casa Grande,3,1,2,6,Ocasional
5876,23,3,3503.6099999999997,Antonella Pacheco,3,1,2,6,Ocasional
5877,21,2,1895.87,Camila das Neves,3,1,1,5,Ocasional
5878,13,4,3635.69,Maria Vitória Cunha,4,2,2,8,Regular
5879,91,4,5739.76,Davi Lucas Mendes,1,2,3,6,Ocasional
5880,3,5,4461.85,Mateus Fogaça,4,3,3,10,VIP
5881,104,5,2612.24,Dra. Isadora Campos,1,3,2,6,Ocasional
5882,56,5,2244.69,Luan Souza,2,3,1,6,Ocasional
5883,48,6,1306.19,Augusto Pastor,2,3,1,6,Ocasional
5884,50,4,2298.83,Juan Teixeira,2,2,2,6,Ocasional
5885,194,4,2656.92,Pedro Lucas Correia,1,2,2,5,Ocasional
5886,75,2,3783.92,Sra. Esther da Rocha,2,1,2,5,Ocasional
5887,43,4,10918.72,Ana Laura Souza,3,2,4,9,Regular
5888,61,3,7287.65,Paulo Leão,2,1,3,6,Ocasional
5889,18,9,4046.6099999999997,Théo Sá,4,4,2,10,VIP
5890,200,1,1931.02,Clarice Freitas,1,1,1,3,Inativo
5891,12,6,3431.0499999999997,Oliver da Paz,4,3,2,9,Regular
5892,39,2,353.47999999999996,Benjamim Monteiro,3,1,1,5,Ocasional
5893,313,1,808.82,Vitor Hugo Gonçalves,1,1,1,3,Inativo
5894,99,3,2430.75,Dr. João Miguel Mendes,1,1,2,4,Ocasional
5895,55,2,3376.1000000000004,Murilo Almeida,2,1,2,5,Ocasional
5897,3,10,9124.85,Dr. Enrico Caldeira,4,4,4,12,VIP
5898,94,3,2660.37,Eduarda Jesus,1,1,2,4,Ocasional
5899,190,1,923.88,Hellena Cirino,1,1,1,3,Inativo
5900,45,4,3751.8199999999997,Kamilly Azevedo,2,2,2,6,Ocasional
5901,220,3,775.48,Henry Gabriel Macedo,1,1,1,3,Inativo
5902,10,8,7776.419999999999,Clarice Vieira,4,4,4,12,VIP
5903,42,5,4601.72,Ravi Lucca Pastor,3,3,3,9,Regular
5904,9,3,1436.13,Luiz Otávio Leão,4,1,1,6,Ocasional
5905,115,5,3043.5499999999997,Matheus Ramos,1,3,2,6,Ocasional
5906,177,2,812.19,Nicole Cunha,1,1,1,3,Inativo
5907,54,6,5316.18,Joana Marques,2,3,3,8,Regular
5908,12,3,1376.06,Dra. Ana Cecília Nogueira,4,1,1,6,Ocasional
5909,12,2,1277.5500000000002,Rebeca Machado,4,1,1,6,Ocasional
5910,56,5,12424.46,Alexia Almeida,2,3,4,9,Regular
5911,22,7,7477.87,Thomas da Conceição,3,4,4,11,VIP
5912,199,4,4489.990000000001,Olivia Peixoto,1,2,3,6,Ocasional
5913,44,5,3488.42,Srta. Maria Vitória Lima,2,3,2,7,Regular
5914,30,2,5471.29,Felipe Rocha,3,1,3,7,Regular
5915,2,6,18492.61,Dr. Miguel Jesus,4,3,4,11,VIP
5916,19,6,12993.46,Gabriela Costa,4,3,4,11,VIP
5917,32,3,5234.21,Ana Vitória Marques,3,1,3,7,Regular
5918,155,2,2368.48,Levi Nunes,1,1,2,4,Ocasional
5919,76,6,4667.46,Catarina Lopes,2,3,3,8,Regular
5920,5,5,6313.3,Ana Vitória Sampaio,4,3,3,10,VIP
5921,92,3,2745.01,Arthur Barros,1,1,2,4,Ocasional
5922,83,6,3390.52,Apollo Ramos,2,3,2,7,Regular
5923,10,7,6506.21,Dr. Fernando Casa Grande,4,4,3,11,VIP
5924,39,5,6269.53,Ester Porto,3,3,3,9,Regular
5925,7,5,3223.71,Gabriel Nunes,4,3,2,9,Regular
5926,54,7,8081.67,Maria Julia Dias,2,4,4,10,VIP
5927,23,6,3786.58,Sr. Felipe Jesus,3,3,2,8,Regular
5928,47,4,3459.44,Dra. Evelyn Silva,2,2,2,6,Ocasional
5929,16,4,6992.240000000001,Sarah Fonseca,4,2,3,9,Regular
5930,89,4,3387.55,Dra. Bruna Novaes,1,2,2,5,Ocasional
5931,6,3,3948.24,Thales Brito,4,1,2,7,Regular
5932,3,10,3588.49,Nina Moraes,4,4,2,10,VIP
5933,2,12,9754.22,Ana Carolina Fernandes,4,4,4,12,VIP
5934,62,5,7178.11,Sr. José Cirino,2,3,3,8,Regular
5935,17,1,933.36,Théo Abreu,4,1,1,6,Ocasional
5936,20,6,8709.58,Sra. Luana Porto,3,3,4,10,VIP
5937,61,1,300.15,Dra. Maria Julia Fonseca,2,1,1,4,Ocasional
5938,39,4,1598.8999999999999,Ana Lívia Pimenta,3,2,1,6,Ocasional
5939,59,4,10825.369999999999,Nina Dias,2,2,4,8,Regular
5940,14,7,13625.49,Ana Lívia Marques,4,4,4,12,VIP
5941,78,4,10847.04,Daniela da Cunha,2,2,4,8,Regular
5942,17,4,2268.59,Sr. Arthur Miguel Aparecida,4,2,2,8,Regular
5943,65,3,1261.12,Rebeca Farias,2,1,1,4,Ocasional
5944,57,5,5675.94,Bella Vieira,2,3,3,8,Regular
5945,58,5,1923.42,Clarice Casa Grande,2,3,1,6,Ocasional
5946,55,3,1291.29,Srta. Helena Ramos,2,1,1,4,Ocasional
5947,275,2,6947.1,Esther Vargas,1,1,3,5,Ocasional
5948,67,4,2244.97,Vitor Gabriel Siqueira,2,2,1,5,Ocasional
5949,23,8,13531.56,Eduardo Melo,3,4,4,11,VIP
5950,9,3,3225.49,Dr. Calebe Carvalho,4,1,2,7,Regular
5951,65,7,4523.24,Luísa Cunha,2,4,3,9,Regular
5952,38,3,958.4000000000001,Dr. Cauã Cunha,3,1,1,5,Ocasional
5953,124,6,4602.85,Ana Lívia Albuquerque,1,3,3,7,Regular
5954,28,8,7339.75,Luiza Sales,3,4,4,11,VIP
5955,18,3,1115.92,Sr. Mathias Oliveira,4,1,1,6,Ocasional
5956,79,3,2026.5700000000002,Laura Pinto,2,1,1,4,Ocasional
5957,40,3,6231.889999999999,Luiz Otávio Peixoto,3,1,3,7,Regular
5958,27,4,1651.1200000000001,Nina Monteiro,3,2,1,6,Ocasional
5959,178,1,607.16,Hellena Costela,1,1,1,3,Inativo
5960,23,3,3088.38,Catarina Fogaça,3,1,2,6,Ocasional
5961,18,4,3305.7599999999998,Henry Gabriel Casa Grande,4,2,2,8,Regular
5962,20,4,2223.2999999999997,Allana da Rosa,3,2,1,6,Ocasional
5963,31,5,6479.6,Caio Souza,3,3,3,9,Regular
5964,59,6,6156.87,Ana Sophia Almeida,2,3,3,8,Regular
5965,34,8,9638.25,Raquel Rocha,3,4,4,11,VIP
5966,71,3,1073.24,Alexia Machado,2,1,1,4,Ocasional
5967,47,6,9448.220000000001,Letícia Albuquerque,2,3,4,9,Regular
5968,111,4,4131.74,Gabrielly Rezende,1,2,2,5,Ocasional
5969,56,2,454.55,José da Costa,2,1,1,4,Ocasional
5970,54,1,92.66,Murilo Pimenta,2,1,1,4,Ocasional
5971,15,3,3241.29,Srta. Maria Luísa Montenegro,4,1,2,7,Regular
5972,38,6,8806.91,Bernardo Sá,3,3,4,10,VIP
5973,7,4,2719.93,Heloísa Pinto,4,2,2,8,Regular
5974,263,2,3846.1400000000003,Lara Castro,1,1,2,4,Ocasional
5975,6,6,6148.16,Fernanda Pinto,4,3,3,10,VIP
5976,102,3,589.3,Dom da Cruz,1,1,1,3,Inativo
5977,35,6,8971.2,Igor Carvalho,3,3,4,10,VIP
5978,38,4,1934.86,Clarice Machado,3,2,1,6,Ocasional
5979,200,1,919.61,Antonella Lima,1,1,1,3,Inativo
5980,58,5,2755.84,Francisco Dias,2,3,2,7,Regular
5981,36,4,5840.2300000000005,Sra. Ana Laura da Rosa,3,2,3,8,Regular
5982,284,2,4736.360000000001,Daniela Lima,1,1,3,5,Ocasional
5983,12,7,5419.7,Pedro Lucas Castro,4,4,3,11,VIP
5984,17,6,6746.3,Henrique Pimenta,4,3,3,10,VIP
5985,174,3,219.27,Dra. Heloisa Monteiro,1,1,1,3,Inativo
5986,74,7,4937.56,Luana Viana,2,4,3,9,Regular
5987,206,3,2208.77,Davi Luiz Sá,1,1,1,3,Inativo
5988,48,5,6419.15,Nicole Machado,2,3,3,8,Regular
5989,28,3,1935.68,Raul Ferreira,3,1,1,5,Ocasional
5990,30,3,4562.16,Diego Duarte,3,1,3,7,Regular
5991,59,5,2557.48,Raul Barbosa,2,3,2,7,Regular
5992,195,3,2970.13,Mariah Dias,1,1,2,4,Ocasional
5993,36,4,3534.9500000000003,Rodrigo Montenegro,3,2,2,7,Regular
5994,13,4,5336.969999999999,Cecilia Almeida,4,2,3,9,Regular
5995,7,5,13893.470000000001,Brayan Costela,4,3,4,11,VIP
5996,187,2,4175.37,Luiz Otávio Rezende,1,1,2,4,Ocasional
5997,50,5,12124.210000000001,Dra. Maria Pereira,2,3,4,9,Regular
5998,26,5,3384.27,Antônio Siqueira,3,3,2,8,Regular
5999,68,4,8056.12,Luara Nunes,2,2,4,8,Regular
6000,7,8,12050.57,Enrico Cassiano,4,4,4,12,VIP
6001,49,7,11562.06,Ana Clara Castro,2,4,4,10,VIP
6002,230,1,5985.48,Rodrigo Novaes,1,1,3,5,Ocasional
6003,21,7,12055.95,Levi da Costa,3,4,4,11,VIP
6004,66,3,4952.9,Sra. Heloísa Aragão,2,1,3,6,Ocasional
6005,172,2,3471.5099999999998,Dr. Pedro Henrique Siqueira,1,1,2,4,Ocasional
6006,55,2,6382.13,Maria Isis das Neves,2,1,3,6,Ocasional
6007,36,4,3579.35,Srta. Olivia Nogueira,3,2,2,7,Regular
6008,19,7,6231.360000000001,Ana Cassiano,4,4,3,11,VIP
6009,69,6,10347.31,Mariane Pinto,2,3,4,9,Regular
6010,115,4,3406.85,Ísis Nascimento,1,2,2,5,Ocasional
6011,29,2,2423.67,Maria Júlia Moreira,3,1,2,6,Ocasional
6012,107,3,2167.3199999999997,Luigi Porto,1,1,1,3,Inativo
6013,4,4,2359.92,Antonella Correia,4,2,2,8,Regular
6014,16,6,6553.16,Larissa Vasconcelos,4,3,3,10,VIP
6015,342,1,2124.21,Maria Clara Pacheco,1,1,1,3,Inativo
6016,84,4,1071.6,João Felipe Andrade,2,2,1,5,Ocasional
6017,38,5,9436.47,Ryan Dias,3,3,4,10,VIP
6018,206,2,1752.45,Carlos Eduardo Gomes,1,1,1,3,Inativo
6019,11,2,4691.2300000000005,Isabella Cunha,4,1,3,8,Regular
6020,25,4,6785.200000000001,Emanuella da Rosa,3,2,3,8,Regular
6021,35,8,9238.57,Pedro Melo,3,4,4,11,VIP
6022,26,4,2166.83,Liz Silveira,3,2,1,6,Ocasional
6023,9,6,6787.92,Luiz Henrique da Rocha,4,3,3,10,VIP
6024,30,6,7159.03,Alexandre Lopes,3,3,3,9,Regular
6025,9,5,2998.15,Dr. Thomas Guerra,4,3,2,9,Regular
6026,31,7,6246.7,Dr. Rael das Neves,3,4,3,10,VIP
6027,7,4,2735.92,Gustavo Henrique da Paz,4,2,2,8,Regular
6028,46,3,2675.0200000000004,Sra. Maria Vitória Moura,2,1,2,5,Ocasional
6029,98,5,2157.1499999999996,Bruno Lopes,1,3,1,5,Ocasional
6030,54,2,2357.9,Heloisa Gonçalves,2,1,2,5,Ocasional
6031,28,4,5335.610000000001,Otávio Jesus,3,2,3,8,Regular
6032,85,3,623.3,Ana Carvalho,2,1,1,4,Ocasional
6033,11,2,150.5,Joana Mendonça,4,1,1,6,Ocasional
6034,34,1,1442.76,Clara da Luz,3,1,1,5,Ocasional
6035,84,6,6608.3099999999995,Leonardo da Paz,2,3,3,8,Regular
6036,90,7,3910.9500000000003,Maria Laura Cirino,1,4,2,7,Regular
6037,21,3,333.31,Rafaela Gomes,3,1,1,5,Ocasional
6038,137,4,2306.62,Alana Novais,1,2,2,5,Ocasional
6039,88,5,14951.650000000001,Danilo Pinto,1,3,4,8,Regular
6040,317,3,6249.7,Sophia Borges,1,1,3,5,Ocasional
6041,24,3,2207.4,Arthur Gabriel Borges,3,1,1,5,Ocasional
6042,51,4,2904.54,Maria Júlia Ferreira,2,2,2,6,Ocasional
6043,2,6,7203.9400000000005,Sr. Josué Moreira,4,3,3,10,VIP
6044,33,3,4558.29,Emanuelly Sales,3,1,3,7,Regular
6045,38,4,7900.1,Davi Lucas Carvalho,3,2,4,9,Regular
6046,52,5,5648.63,Dra. Eloá Ferreira,2,3,3,8,Regular
6047,137,3,3238.16,João Lucas Ferreira,1,1,2,4,Ocasional
6048,28,7,4758.83,Ana Carolina Novaes,3,4,3,10,VIP
6049,56,4,5750.8,Luigi Câmara,2,2,3,7,Regular
6050,26,6,4663.92,Ana Liz Souza,3,3,3,9,Regular
6051,22,2,869.23,Ester Vieira,3,1,1,5,Ocasional
6052,22,3,2658.87,Sra. Zoe Sá,3,1,2,6,Ocasional
6053,200,3,7237.6,Pedro Silveira,1,1,3,5,Ocasional
6054,22,5,2352.36,Dom Casa Grande,3,3,2,8,Regular
6055,25,3,2634.86,Yan Costela,3,1,2,6,Ocasional
6056,114,2,3594.11,Isaac Nascimento,1,1,2,4,Ocasional
6057,20,7,12934.11,Benjamim Mendes,3,4,4,11,VIP
6058,4,3,2302.66,Vinícius Machado,4,1,2,7,Regular
6059,38,10,8702.02,Olivia Rios,3,4,4,11,VIP
6060,7,4,6346.16,Natália Pimenta,4,2,3,9,Regular
6061,59,3,1251.23,Vitória Viana,2,1,1,4,Ocasional
6062,20,5,3803.58,Bernardo Câmara,3,3,2,8,Regular
6063,40,5,8513.54,Srta. Maria Alice da Cunha,3,3,4,10,VIP
6064,99,1,278.16,Sofia Fonseca,1,1,1,3,Inativo
6065,52,3,1649.96,Alexandre Moreira,2,1,1,4,Ocasional
6066,8,5,8227.32,Marina da Paz,4,3,4,11,VIP
6067,7,7,8855.1,Theo Monteiro,4,4,4,12,VIP
6068,16,1,1649.06,Heloisa Freitas,4,1,1,6,Ocasional
6069,64,4,914.51,Bárbara Vieira,2,2,1,5,Ocasional
6070,92,3,1457.8000000000002,Caleb Leão,1,1,1,3,Inativo
6071,94,5,6686.75,Dra. Allana Monteiro,1,3,3,7,Regular
6072,71,3,4344.74,Isaque Souza,2,1,2,5,Ocasional
6073,28,2,4444.1,Laís Castro,3,1,3,7,Regular
6074,6,5,9505.24,Dra. Laís Mendonça,4,3,4,11,VIP
6075,3,5,4336.64,Gabrielly Castro,4,3,2,9,Regular
6076,69,3,3612.7599999999998,Sra. Maria Fernanda da Mata,2,1,2,5,Ocasional
6077,263,3,1496.46,Otto Pimenta,1,1,1,3,Inativo
6078,4,14,23892.44,Leandro da Conceição,4,4,4,12,VIP
6079,40,12,10163.71,Dra. Mariana Dias,3,4,4,11,VIP
6080,30,4,6284.67,Vicente da Luz,3,2,3,8,Regular
6081,24,7,14132.1,Sra. Lorena Abreu,3,4,4,11,VIP
6082,40,8,8264.06,Miguel Pacheco,3,4,4,11,VIP
6083,50,5,2240.29,Rebeca Cavalcanti,2,3,1,6,Ocasional
6084,80,2,2022.1599999999999,Arthur Fogaça,2,1,1,4,Ocasional
6085,143,1,614.87,Camila Jesus,1,1,1,3,Inativo
6086,58,4,3503.96,Pedro Rocha,2,2,2,6,Ocasional
6087,196,2,4250.1900000000005,Théo das Neves,1,1,2,4,Ocasional
6088,14,9,8881.64,Théo Viana,4,4,4,12,VIP
6089,50,3,7442.38,Dr. Nicolas Câmara,2,1,4,7,Regular
6090,53,5,10632.619999999999,Srta. Sara Pires,2,3,4,9,Regular
6091,125,2,1602.69,Lorenzo Barbosa,1,1,1,3,Inativo
6092,180,1,160.27,Raul Pires,1,1,1,3,Inativo
6093,55,7,3913.3100000000004,Arthur Miguel Pastor,2,4,2,8,Regular
6094,46,3,914.4,Maria Isis da Mota,2,1,1,4,Ocasional
6095,16,4,3058.95,Anthony Aparecida,4,2,2,8,Regular
6096,238,2,5755.63,Isaac da Paz,1,1,3,5,Ocasional
6097,23,6,5896.24,Aurora Pastor,3,3,3,9,Regular
6098,24,3,3793.59,Sarah Caldeira,3,1,2,6,Ocasional
6099,238,2,3133.3599999999997,Isabela Machado,1,1,2,4,Ocasional
6100,44,5,947.47,Rafael Santos,2,3,1,6,Ocasional
6101,155,7,11354.88,Eloah Cardoso,1,4,4,9,Regular
6102,145,3,3272.66,Raquel das Neves,1,1,2,4,Ocasional
6103,17,2,1552.02,Sr. Léo Brito,4,1,1,6,Ocasional
6104,48,3,5745.63,Maria Liz Farias,2,1,3,6,Ocasional
6105,79,2,812.13,Luara Garcia,2,1,1,4,Ocasional
6106,8,4,3279.44,Augusto Barros,4,2,2,8,Regular
6107,352,1,1378.56,Eloah Pastor,1,1,1,3,Inativo
6108,76,5,10125.98,Kaique Câmara,2,3,4,9,Regular
6109,46,9,8936.52,Maria Cecília Martins,2,4,4,10,VIP
6110,75,2,1124.1799999999998,Pietro Cassiano,2,1,1,4,Ocasional
6111,30,4,4036.02,Mathias Sousa,3,2,2,7,Regular
6113,116,5,8895.68,Manuela Campos,1,3,4,8,Regular
6114,40,8,16163.279999999999,João Pedro da Costa,3,4,4,11,VIP
6115,2,4,16860.050000000003,Bárbara da Rosa,4,2,4,10,VIP
6116,42,7,9108.869999999999,Dr. Benicio Brito,3,4,4,11,VIP
6117,121,3,4294.62,Laura Farias,1,1,2,4,Ocasional
6118,61,3,7323.45,Ana Clara da Cunha,2,1,4,7,Regular
6119,34,4,3492.1499999999996,Isabela Dias,3,2,2,7,Regular
6120,12,4,2250.94,Raul Fonseca,4,2,1,7,Regular
6121,55,5,6237.08,Gabriela Lima,2,3,3,8,Regular
6122,5,5,6155.72,Luiz Felipe da Rosa,4,3,3,10,VIP
6123,10,7,7947.57,Heitor Almeida,4,4,4,12,VIP
6124,39,3,1025.05,Marcelo Souza,3,1,1,5,Ocasional
6125,30,8,12201.73,Gael Leão,3,4,4,11,VIP
6126,33,5,8603.25,Augusto Novais,3,3,4,10,VIP
6127,13,4,5554.56,Amanda Andrade,4,2,3,9,Regular
6128,45,3,7134.98,Alexia Sales,2,1,3,6,Ocasional
6129,54,5,8403.0,Vitor Hugo Cunha,2,3,4,9,Regular
6130,2,5,4324.44,Ana Clara Caldeira,4,3,2,9,Regular
6131,155,5,2330.7200000000003,Stephany da Luz,1,3,2,6,Ocasional
6132,1,10,15747.91,Emanuelly Freitas,4,4,4,12,VIP
6133,2,3,5472.5599999999995,Arthur Miguel Costela,4,1,3,8,Regular
6134,79,7,10203.59,Zoe Guerra,2,4,4,10,VIP
6135,88,4,1869.83,Sr. Yago Borges,1,2,1,4,Ocasional
6136,219,1,62.95,Leandro da Conceição,1,1,1,3,Inativo
6137,27,6,3700.54,Caio Almeida,3,3,2,8,Regular
6138,96,3,1055.3,Pietra da Luz,1,1,1,3,Inativo
6139,26,4,7682.950000000001,Pedro Miguel Mendonça,3,2,4,9,Regular
6140,1,7,10700.86,Gustavo Henrique Monteiro,4,4,4,12,VIP
6141,29,6,12922.599999999999,Apollo Cavalcante,3,3,4,10,VIP
6142,18,5,6477.41,Catarina Freitas,4,3,3,10,VIP
6144,66,9,13549.55,Clarice Barbosa,2,4,4,10,VIP
6145,8,4,3378.3,Ana Lívia Pires,4,2,2,8,Regular
6146,19,8,9435.66,Vinícius Sales,4,4,4,12,VIP
6147,172,2,2242.29,Sr. Ravi Lucca da Costa,1,1,1,3,Inativo
6148,214,3,3134.7999999999997,Enzo Gabriel Pastor,1,1,2,4,Ocasional
6149,207,3,3517.43,Mathias Costela,1,1,2,4,Ocasional
6150,10,4,2238.5499999999997,Anthony Gabriel Barbosa,4,2,1,7,Regular
6151,113,3,3362.26,Yasmin Barbosa,1,1,2,4,Ocasional
6152,91,4,13533.15,Igor Casa Grande,1,2,4,7,Regular
6153,12,5,2035.1100000000001,Erick Duarte,4,3,1,8,Regular
6154,12,4,14504.8,Bella Araújo,4,2,4,10,VIP
6155,33,7,16406.77,Beatriz da Rocha,3,4,4,11,VIP
6156,57,4,2855.35,Kamilly Teixeira,2,2,2,6,Ocasional
6157,94,4,2369.62,Sra. Sofia Marques,1,2,2,5,Ocasional
6158,29,6,3717.74,Maria Júlia Viana,3,3,2,8,Regular
6159,15,6,6806.07,Ana Júlia Camargo,4,3,3,10,VIP
6160,11,6,5096.96,Larissa Farias,4,3,3,10,VIP
6161,64,4,4549.34,Yan Ribeiro,2,2,3,7,Regular
6162,105,5,2873.66,Valentim Sousa,1,3,2,6,Ocasional
6163,11,1,1323.23,Bianca Sampaio,4,1,1,6,Ocasional
6164,45,4,6681.65,Cauã Novais,2,2,3,7,Regular
6165,68,1,1149.47,Dante Lima,2,1,1,4,Ocasional
6166,22,5,8529.91,Marina Monteiro,3,3,4,10,VIP
6167,27,5,4852.96,Sr. Valentim Fonseca,3,3,3,9,Regular
6168,76,2,4820.54,Léo Almeida,2,1,3,6,Ocasional
6169,132,2,258.34000000000003,Bruno Garcia,1,1,1,3,Inativo
6170,166,4,3491.31,José Pimenta,1,2,2,5,Ocasional
6171,20,1,350.43,Luiza da Rocha,3,1,1,5,Ocasional
6172,252,2,2197.44,Matheus Novais,1,1,1,3,Inativo
6173,9,6,5474.22,Maria Martins,4,3,3,10,VIP
6174,58,6,4984.93,Sra. Ana Liz Cavalcanti,2,3,3,8,Regular
6175,84,2,5502.93,Ravi Lucca Gonçalves,2,1,3,6,Ocasional
6176,314,1,173.9,Enrico Cassiano,1,1,1,3,Inativo
6177,8,4,4704.66,Maria Cecília Costa,4,2,3,9,Regular
6178,77,5,3981.37,Dr. Anthony Gabriel Fonseca,2,3,2,7,Regular
6179,51,5,3376.0499999999997,Marcelo Viana,2,3,2,7,Regular
6180,27,4,2788.65,José Pedro Moreira,3,2,2,7,Regular
6181,37,2,1618.24,Antonella Pacheco,3,1,1,5,Ocasional
6182,24,7,4335.12,Clara Abreu,3,4,2,9,Regular
6183,37,6,8022.38,Agatha Vargas,3,3,4,10,VIP
6184,8,5,5630.15,João Felipe da Paz,4,3,3,10,VIP
6185,32,4,1772.21,Nathan Melo,3,2,1,6,Ocasional
6186,10,5,6002.04,Sophie Cunha,4,3,3,10,VIP
6187,25,5,2936.6800000000003,Rafael Caldeira,3,3,2,8,Regular
6188,43,11,9580.36,Caroline Monteiro,3,4,4,11,VIP
6189,49,3,7026.35,Letícia Leão,2,1,3,6,Ocasional
6190,70,3,12915.82,Jade Cavalcante,2,1,4,7,Regular
6191,112,2,725.83,Lavínia Carvalho,1,1,1,3,Inativo
6192,150,5,4668.61,João Gabriel Ferreira,1,3,3,7,Regular
6193,20,5,6403.62,Danilo Novaes,3,3,3,9,Regular
6194,77,6,11826.99,Maria Liz Pimenta,2,3,4,9,Regular
6195,166,3,2569.7,Antony Castro,1,1,2,4,Ocasional
6196,62,4,7939.18,Heitor Cirino,2,2,4,8,Regular
6197,171,4,3050.4,Srta. Rebeca Cavalcanti,1,2,2,5,Ocasional
6198,224,1,112.0,Rebeca Andrade,1,1,1,3,Inativo
6200,2,4,1212.62,Brayan da Cunha,4,2,1,7,Regular
6201,172,2,1602.71,Igor Lopes,1,1,1,3,Inativo
6202,24,4,2912.6499999999996,João Vitor Cavalcanti,3,2,2,7,Regular
6203,78,5,2300.46,Letícia Rios,2,3,2,7,Regular
6204,125,3,2978.2699999999995,Benicio Vieira,1,1,2,4,Ocasional
6205,17,3,7349.43,Lara Viana,4,1,4,9,Regular
6206,8,3,703.23,Ana Cecília Borges,4,1,1,6,Ocasional
6207,108,2,2136.76,Pietra Pinto,1,1,1,3,Inativo
6208,17,8,12180.16,Maria Flor Gonçalves,4,4,4,12,VIP
6209,39,3,1261.51,Matteo Pacheco,3,1,1,5,Ocasional
6210,225,3,7044.64,Sra. Maria Costa,1,1,3,5,Ocasional
6211,71,4,4776.15,Antony da Paz,2,2,3,7,Regular
6212,53,5,14672.849999999999,Evelyn Lima,2,3,4,9,Regular
6213,306,1,466.87,Heloísa Mendes,1,1,1,3,Inativo
6214,7,5,5879.62,Zoe Cunha,4,3,3,10,VIP
6215,91,4,7209.57,Hadassa Duarte,1,2,3,6,Ocasional
6216,47,6,7692.18,Erick Siqueira,2,3,4,9,Regular
6217,25,3,979.6800000000001,Diogo Vieira,3,1,1,5,Ocasional
6218,48,2,11180.03,Bernardo Pereira,2,1,4,7,Regular
6219,48,4,3633.4,Yago Borges,2,2,2,6,Ocasional
6220,243,2,7606.12,Dom Sales,1,1,4,6,Ocasional
6221,123,3,2157.41,Dra. Camila Melo,1,1,1,3,Inativo
6222,35,5,6844.39,Bárbara Azevedo,3,3,3,9,Regular
6223,45,8,4879.91,Rhavi Albuquerque,2,4,3,9,Regular
6224,52,9,18753.38,Maria Laura Martins,2,4,4,10,VIP
6225,31,6,4381.33,Francisco das Neves,3,3,3,9,Regular
6226,33,2,3205.6,Guilherme Sales,3,1,2,6,Ocasional
6227,31,4,1105.6,Anthony Gabriel Teixeira,3,2,1,6,Ocasional
6228,6,3,1597.67,Dr. João Miguel da Cunha,4,1,1,6,Ocasional
6229,5,5,2476.47,Valentim Caldeira,4,3,2,9,Regular
6230,62,4,6110.21,Kamilly Azevedo,2,2,3,7,Regular
6231,17,4,3602.46,Dr. Léo Nascimento,4,2,2,8,Regular
6232,36,5,6449.18,Aurora Casa Grande,3,3,3,9,Regular
6233,24,2,336.49,Asafe Sampaio,3,1,1,5,Ocasional
6234,98,2,2488.6800000000003,Mathias Lima,1,1,2,4,Ocasional
6235,8,9,8099.4800000000005,Srta. Stella Gonçalves,4,4,4,12,VIP
6236,210,2,1169.87,Anna Liz Cirino,1,1,1,3,Inativo
6237,13,2,525.78,Enrico Macedo,4,1,1,6,Ocasional
6238,148,3,2121.52,Dr. Anthony Gabriel da Rocha,1,1,1,3,Inativo
6240,146,4,8976.24,João Miguel Cardoso,1,2,4,7,Regular
6241,1,7,5712.049999999999,Isadora Pastor,4,4,3,11,VIP
6242,13,6,12033.94,Ian Pinto,4,3,4,11,VIP
6243,185,5,7217.5,Luiz Gustavo Vieira,1,3,3,7,Regular
6244,44,4,1785.6399999999999,Maria Sophia Montenegro,2,2,1,5,Ocasional
6245,27,4,6125.88,Felipe Pereira,3,2,3,8,Regular
6246,65,4,1843.48,Dra. Manuella Pereira,2,2,1,5,Ocasional
6247,49,4,4469.78,Melissa Melo,2,2,3,7,Regular
6248,61,7,6925.4800000000005,Pietro Vasconcelos,2,4,3,9,Regular
6249,224,3,4336.5,Ravy Rezende,1,1,2,4,Ocasional
6250,4,6,8070.34,Sra. Eloá Macedo,4,3,4,11,VIP
6251,33,6,9484.23,Vitor Hugo Pereira,3,3,4,10,VIP
6252,13,10,9726.15,Maria Fernanda Lima,4,4,4,12,VIP
6253,171,2,7304.14,Raul Aparecida,1,1,3,5,Ocasional
6254,51,4,2189.45,Ester Camargo,2,2,1,5,Ocasional
6255,62,3,4514.43,Melina Pinto,2,1,3,6,Ocasional
6256,55,4,2147.66,Arthur Gabriel Fonseca,2,2,1,5,Ocasional
6257,80,2,7739.36,Sophie Moreira,2,1,4,7,Regular
6258,8,4,1377.16,Fernando Fonseca,4,2,1,7,Regular
6259,12,5,5597.67,Theodoro Silveira,4,3,3,10,VIP
6260,80,3,1149.28,Dra. Maria Liz Machado,2,1,1,4,Ocasional
6261,61,6,9186.16,Helena Casa Grande,2,3,4,9,Regular
6262,4,5,14195.52,Sra. Maria Alice Mendes,4,3,4,11,VIP
6263,9,6,2702.13,Brayan Ferreira,4,3,2,9,Regular
6264,27,5,4780.0,Isaac Ramos,3,3,3,9,Regular
6265,35,3,6623.599999999999,Davi Lucas Gomes,3,1,3,7,Regular
6266,6,4,7198.0,Vitor Pires,4,2,3,9,Regular
6267,34,4,7442.09,Maria Julia Siqueira,3,2,4,9,Regular
6268,68,6,6508.6,Caleb Abreu,2,3,3,8,Regular
6269,51,5,9731.33,Juliana Rios,2,3,4,9,Regular
6270,60,3,7448.129999999999,José Pedro Aragão,2,1,4,7,Regular
6271,81,6,13042.07,Otto Caldeira,2,3,4,9,Regular
6272,30,2,1124.82,Pedro Lucas Novais,3,1,1,5,Ocasional
6273,23,3,882.6,Heloísa Peixoto,3,1,1,5,Ocasional
6274,97,2,1807.56,Gustavo da Luz,1,1,1,3,Inativo
6275,142,1,2844.12,Henrique Mendonça,1,1,2,4,Ocasional
6276,7,2,3396.54,Alexia Lima,4,1,2,7,Regular
6277,62,4,1374.22,Heloísa Cavalcanti,2,2,1,5,Ocasional
6278,59,1,1653.48,Valentim Nunes,2,1,1,4,Ocasional
6279,24,6,7066.69,Bianca Ferreira,3,3,3,9,Regular
6280,14,7,11769.65,Juan Novaes,4,4,4,12,VIP
6281,23,2,2943.5299999999997,Luan Porto,3,1,2,6,Ocasional
6282,20,4,4926.41,Sarah Nogueira,3,2,3,8,Regular
6283,29,3,3811.34,Pedro Lucas Aragão,3,1,2,6,Ocasional
6285,37,4,4501.209999999999,Dra. Luana Farias,3,2,3,8,Regular
6286,13,2,1720.58,Benjamin Mendes,4,1,1,6,Ocasional
6287,83,2,723.28,Otávio Albuquerque,2,1,1,4,Ocasional
6288,39,5,4560.62,Yago Silva,3,3,3,9,Regular
6289,60,3,3293.7599999999998,Agatha Moraes,2,1,2,5,Ocasional
6290,42,2,1155.95,Dr. Ravy Carvalho,3,1,1,5,Ocasional
6291,238,2,3500.2,Sr. Murilo Fogaça,1,1,2,4,Ocasional
6292,3,4,7506.6,Alexia Abreu,4,2,4,10,VIP
6293,5,7,6861.56,Leandro da Costa,4,4,3,11,VIP
6294,336,1,563.44,Esther Barros,1,1,1,3,Inativo
6295,151,4,7829.0,Gabriela Casa Grande,1,2,4,7,Regular
6296,37,2,542.65,Isadora Borges,3,1,1,5,Ocasional
6297,108,4,8315.78,Sr. Gustavo Henrique Farias,1,2,4,7,Regular
6298,5,4,3311.56,Julia Lopes,4,2,2,8,Regular
6299,15,3,2792.77,Zoe Barros,4,1,2,7,Regular
6300,38,4,1638.23,Maria Flor Vargas,3,2,1,6,Ocasional
6301,287,1,69.86,Pedro Lucas Martins,1,1,1,3,Inativo
6302,11,9,14158.94,Matteo Garcia,4,4,4,12,VIP
6303,61,3,4851.04,Gustavo Henrique Novaes,2,1,3,6,Ocasional
6304,108,6,7655.91,Sra. Emilly Pereira,1,3,4,8,Regular
6305,187,5,6795.98,Ana Liz Rezende,1,3,3,7,Regular
6306,38,4,1742.34,Maria Luiza Montenegro,3,2,1,6,Ocasional
6307,109,3,3512.75,Srta. Esther Siqueira,1,1,2,4,Ocasional
6308,110,5,2748.17,Kaique Sales,1,3,2,6,Ocasional
6309,49,7,7208.9,Apollo Vasconcelos,2,4,3,9,Regular
6310,60,3,3476.24,Sra. Laura Brito,2,1,2,5,Ocasional
6311,53,4,4450.04,Pedro Lucas da Mata,2,2,3,7,Regular
6312,56,2,1465.09,Alícia Freitas,2,1,1,4,Ocasional
6313,1,2,3436.35,Aylla Pires,4,1,2,7,Regular
6314,158,4,1778.4199999999998,Bento Mendes,1,2,1,4,Ocasional
6315,30,4,4003.59,Mariana Vasconcelos,3,2,2,7,Regular
6316,18,5,3004.16,Sr. Augusto Moura,4,3,2,9,Regular
6317,160,2,7646.12,Eloá Camargo,1,1,4,6,Ocasional
6318,29,3,2870.49,Mariah Melo,3,1,2,6,Ocasional
6319,38,8,6699.98,Cecilia Alves,3,4,3,10,VIP
6320,105,1,103.46,Luan Novaes,1,1,1,3,Inativo
6321,238,2,4537.07,Kevin Rodrigues,1,1,3,5,Ocasional
6322,92,4,11794.98,Dra. Isabella Abreu,1,2,4,7,Regular
6323,63,6,3233.58,Maria Flor Borges,2,3,2,7,Regular
6324,58,1,30.96,Marcos Vinicius Borges,2,1,1,4,Ocasional
6325,2,2,1641.3200000000002,Kaique Fogaça,4,1,1,6,Ocasional
6326,13,5,8190.6,Ian Martins,4,3,4,11,VIP
6327,14,7,7056.61,Maria Julia Brito,4,4,3,11,VIP
6328,72,4,10851.39,Isabella Vieira,2,2,4,8,Regular
6329,154,7,3423.62,Emanuel Montenegro,1,4,2,7,Regular
6330,38,4,2679.2799999999997,Maria Eduarda Lopes,3,2,2,7,Regular
6331,30,2,1906.42,Dr. André Correia,3,1,1,5,Ocasional
6332,266,1,1537.12,Théo da Cunha,1,1,1,3,Inativo
6333,16,5,4170.52,Manuela Barbosa,4,3,2,9,Regular
6334,2,5,5971.38,Marina Caldeira,4,3,3,10,VIP
6335,132,4,12122.61,Heloísa Caldeira,1,2,4,7,Regular
6336,33,6,15887.720000000001,Olivia Silva,3,3,4,10,VIP
6337,9,8,10411.24,Dra. Emanuelly Sousa,4,4,4,12,VIP
6338,334,1,472.03,Helena Ribeiro,1,1,1,3,Inativo
6339,58,6,6840.150000000001,Ana Luiza Correia,2,3,3,8,Regular
6340,45,4,6205.15,Daniela Novais,2,2,3,7,Regular
6341,25,5,7135.72,Liam Ramos,3,3,3,9,Regular
6342,134,1,3492.6,Valentina Vasconcelos,1,1,2,4,Ocasional
6343,76,5,4772.73,Ana Júlia Cavalcanti,2,3,3,8,Regular
6344,37,7,10868.1,Vitória Silveira,3,4,4,11,VIP
6345,8,8,10502.52,Ester Rodrigues,4,4,4,12,VIP
6346,86,4,5232.8,Eduardo Porto,2,2,3,7,Regular
6347,48,6,6373.5599999999995,Murilo Correia,2,3,3,8,Regular
6348,18,6,12027.2,Benjamim Vasconcelos,4,3,4,11,VIP
6349,54,5,5594.36,Esther Rezende,2,3,3,8,Regular
6350,37,4,6945.83,Brayan Melo,3,2,3,8,Regular
6351,124,3,1014.0999999999999,Juliana Pacheco,1,1,1,3,Inativo
6352,277,1,1116.0,Calebe da Cunha,1,1,1,3,Inativo
6353,59,6,1975.68,Maria Vitória Albuquerque,2,3,1,6,Ocasional
6354,1,2,1321.15,Sr. Kevin da Paz,4,1,1,6,Ocasional
6355,31,6,4120.25,Maria Laura Silveira,3,3,2,8,Regular
6356,15,5,8154.8099999999995,Stephany Cardoso,4,3,4,11,VIP
6357,64,2,4724.530000000001,Olívia da Conceição,2,1,3,6,Ocasional
6358,5,5,4467.85,Isis Cunha,4,3,3,10,VIP
6359,31,8,14413.3,Daniel Sales,3,4,4,11,VIP
6360,34,6,9803.66,Catarina Rodrigues,3,3,4,10,VIP
6361,11,6,7686.59,Maria Alice da Costa,4,3,4,11,VIP
6362,2,8,3028.94,Sr. Mateus Costela,4,4,2,10,VIP
6363,37,3,2724.24,Maitê Melo,3,1,2,6,Ocasional
6364,85,5,2713.9,Davi Luiz Almeida,2,3,2,7,Regular
6365,154,4,5392.51,Kevin Aparecida,1,2,3,6,Ocasional
6366,20,3,9040.289999999999,Sra. Jade Caldeira,3,1,4,8,Regular
6367,5,9,5676.17,Srta. Evelyn Sá,4,4,3,11,VIP
6368,85,7,11214.75,Ravi Lucca Leão,2,4,4,10,VIP
6369,146,3,2343.02,Vitor Sales,1,1,2,4,Ocasional
6370,26,5,6823.79,Lucas Gabriel Marques,3,3,3,9,Regular
6371,5,7,18682.03,Davi Sales,4,4,4,12,VIP
6372,111,5,5855.83,Diogo Silveira,1,3,3,7,Regular
6373,3,6,6350.92,Milena Machado,4,3,3,10,VIP
6374,327,1,575.44,Júlia Correia,1,1,1,3,Inativo
6375,144,6,9972.01,Natália Machado,1,3,4,8,Regular
6376,8,6,8896.69,Ryan Pastor,4,3,4,11,VIP
6377,13,3,3106.87,Melina Oliveira,4,1,2,7,Regular
6378,52,2,3165.98,Sra. Stella Peixoto,2,1,2,5,Ocasional
6379,60,3,6591.469999999999,Dra. Sophia da Costa,2,1,3,6,Ocasional
6380,50,6,6027.860000000001,João Lucas Abreu,2,3,3,8,Regular
6381,121,4,3983.24,Rafaela da Paz,1,2,2,5,Ocasional
6382,87,3,1564.79,Sr. Luiz Otávio das Neves,2,1,1,4,Ocasional
6383,7,5,4967.79,Marcelo Oliveira,4,3,3,10,VIP
6384,57,3,3175.94,Clarice Câmara,2,1,2,5,Ocasional
6385,41,3,2321.13,Sophie Araújo,3,1,2,6,Ocasional
6386,56,8,3720.44,Arthur Gabriel Viana,2,4,2,8,Regular
6387,8,3,6857.16,Sr. Ravi Lucca Dias,4,1,3,8,Regular
6388,11,7,4007.7400000000002,Ísis Porto,4,4,2,10,VIP
6389,5,5,6913.75,Ana Carolina da Conceição,4,3,3,10,VIP
6390,40,5,5685.66,Bento Gomes,3,3,3,9,Regular
6391,39,6,5766.21,Dr. Luiz Otávio Aparecida,3,3,3,9,Regular
6392,20,2,3050.91,Dra. Vitória Carvalho,3,1,2,6,Ocasional
6393,33,6,4624.38,Alexandre Moraes,3,3,3,9,Regular
6394,44,3,823.25,Mateus da Mota,2,1,1,4,Ocasional
6395,159,3,1820.55,Enzo Souza,1,1,1,3,Inativo
6396,9,8,7345.44,Dante Cunha,4,4,4,12,VIP
6397,1,6,5576.91,Sr. Erick Carvalho,4,3,3,10,VIP
6398,47,5,3110.41,Lucca Câmara,2,3,2,7,Regular
6399,132,4,6112.59,Vitor Hugo Borges,1,2,3,6,Ocasional
6400,55,5,16883.5,Zoe Borges,2,3,4,9,Regular
6401,49,4,2180.85,Cauê Ferreira,2,2,1,5,Ocasional
6402,3,7,6680.96,Kevin Rocha,4,4,3,11,VIP
6403,97,1,219.26,Amanda Pimenta,1,1,1,3,Inativo
6404,14,7,5810.360000000001,Gabrielly Pimenta,4,4,3,11,VIP
6405,23,3,3133.38,Dr. Luiz Fernando Jesus,3,1,2,6,Ocasional
6406,90,3,4584.93,Luana da Mata,1,1,3,5,Ocasional
6407,1,6,11936.2,Josué Rezende,4,3,4,11,VIP
6408,50,5,8732.75,Mariana Novaes,2,3,4,9,Regular
6409,8,4,4457.67,Diego Nogueira,4,2,3,9,Regular
6411,94,4,5880.97,Julia Moreira,1,2,3,6,Ocasional
6412,114,4,7591.21,Dra. Ísis Cirino,1,2,4,7,Regular
6413,44,5,1639.22,Ravi Rocha,2,3,1,6,Ocasional
6414,28,4,13114.11,Levi da Cruz,3,2,4,9,Regular
6415,83,6,3929.69,Davi Miguel Leão,2,3,2,7,Regular
6416,255,2,449.77,Srta. Ana Julia Montenegro,1,1,1,3,Inativo
6417,281,1,772.39,José Miguel Aragão,1,1,1,3,Inativo
6418,5,5,5809.049999999999,Joaquim Vasconcelos,4,3,3,10,VIP
6419,62,3,3808.6499999999996,Antony Pastor,2,1,2,5,Ocasional
6420,10,7,5953.799999999999,Carlos Eduardo Machado,4,4,3,11,VIP
6421,5,2,9943.800000000001,Dr. Juan Cassiano,4,1,4,9,Regular
6422,54,4,1734.4499999999998,Dr. Antônio Nunes,2,2,1,5,Ocasional
6423,78,2,5057.65,Thiago Rios,2,1,3,6,Ocasional
6424,48,2,5212.88,Thiago Pastor,2,1,3,6,Ocasional
6425,17,4,3378.2200000000003,Dr. Henry Gabriel Pires,4,2,2,8,Regular
6426,174,4,9689.2,Bruno Ferreira,1,2,4,7,Regular
6427,50,3,1183.3000000000002,Caleb da Luz,2,1,1,4,Ocasional
6428,14,3,2655.98,Dra. Maria Isis Cassiano,4,1,2,7,Regular
6429,114,3,945.72,Maria Clara Leão,1,1,1,3,Inativo
6430,57,4,3752.19,Maria Alice Fernandes,2,2,2,6,Ocasional
6431,49,5,2112.82,Natália Oliveira,2,3,1,6,Ocasional
6432,49,5,2077.27,Ian das Neves,2,3,1,6,Ocasional
6433,8,5,6624.01,Gabrielly Monteiro,4,3,3,10,VIP
6434,126,4,6360.879999999999,Ana Laura Camargo,1,2,3,6,Ocasional
6435,21,4,7092.900000000001,João Miguel Souza,3,2,3,8,Regular
6436,29,9,4179.24,Maria Cecília das Neves,3,4,2,9,Regular
6437,20,5,10601.11,Maria Flor Abreu,3,3,4,10,VIP
6438,228,4,4087.4399999999996,Enzo Gabriel da Paz,1,2,2,5,Ocasional
6439,2,5,5258.46,Cecília Borges,4,3,3,10,VIP
6440,19,4,4643.52,Ana Laura Garcia,4,2,3,9,Regular
6441,310,1,44.86,Maria Fernanda Silva,1,1,1,3,Inativo
6442,85,4,7691.759999999999,Sra. Bárbara Leão,2,2,4,8,Regular
6443,49,3,2519.3,Gael Henrique da Cunha,2,1,2,5,Ocasional
6444,152,4,5677.72,Ester Lima,1,2,3,6,Ocasional
6445,71,12,12627.26,Dr. Théo Barbosa,2,4,4,10,VIP
6446,2,4,6345.09,Danilo Ferreira,4,2,3,9,Regular
6447,34,4,2454.0299999999997,Ana Cecília Nascimento,3,2,2,7,Regular
6448,41,6,5709.82,Leandro Pinto,3,3,3,9,Regular
6449,5,3,4761.72,Maysa Fogaça,4,1,3,8,Regular
6450,119,3,1593.86,Carlos Eduardo Gomes,1,1,1,3,Inativo
6451,6,1,99.09,Luan da Paz,4,1,1,6,Ocasional
6452,6,4,5386.150000000001,Théo Novais,4,2,3,9,Regular
6453,97,1,260.34,Srta. Eloá da Rosa,1,1,1,3,Inativo
6454,2,2,717.15,Raul Nunes,4,1,1,6,Ocasional
6455,49,3,7127.860000000001,Alícia Fernandes,2,1,3,6,Ocasional
6456,115,2,423.04,Miguel Barbosa,1,1,1,3,Inativo
6457,42,5,2756.5,Benicio Fogaça,3,3,2,8,Regular
6458,45,7,4627.59,Caio Marques,2,4,3,9,Regular
6459,103,2,6300.53,Lívia Machado,1,1,3,5,Ocasional
6460,28,2,623.42,Gustavo Campos,3,1,1,5,Ocasional
6461,281,2,978.92,Isaque da Luz,1,1,1,3,Inativo
6462,72,4,2325.01,Dr. Leonardo Pimenta,2,2,2,6,Ocasional
6463,7,7,7319.360000000001,Milena Vargas,4,4,4,12,VIP
6464,30,4,4788.91,Sra. Isabel Campos,3,2,3,8,Regular
6465,306,1,918.68,Maria Isis Aparecida,1,1,1,3,Inativo
6466,31,6,6818.42,Heloisa da Mota,3,3,3,9,Regular
6467,26,8,6749.69,Gabrielly da Cruz,3,4,3,10,VIP
6468,120,4,3403.16,Joaquim Rodrigues,1,2,2,5,Ocasional
6469,9,8,10713.28,Eduarda Lima,4,4,4,12,VIP
6470,67,1,1251.79,Luigi Alves,2,1,1,4,Ocasional
6471,162,2,2733.08,Dra. Alexia da Mota,1,1,2,4,Ocasional
6472,2,8,12458.949999999999,Heloisa Pacheco,4,4,4,12,VIP
6473,61,3,3852.3199999999997,Dr. Igor Correia,2,1,2,5,Ocasional
6474,66,6,15404.83,Ryan Costela,2,3,4,9,Regular
6475,40,3,5642.63,Igor Montenegro,3,1,3,7,Regular
6476,25,5,5323.9,Sra. Marcela da Cunha,3,3,3,9,Regular
6477,305,1,779.24,Juliana da Conceição,1,1,1,3,Inativo
6478,221,1,382.62,Sophia da Conceição,1,1,1,3,Inativo
6479,30,3,3144.0,Maria Eduarda Vieira,3,1,2,6,Ocasional
6480,34,7,3413.11,Alexia Alves,3,4,2,9,Regular
6481,156,8,15352.62,Dr. Vinicius Pires,1,4,4,9,Regular
6482,1,7,8743.72,Isabel da Cunha,4,4,4,12,VIP
6483,53,3,6304.25,Ana Liz Ferreira,2,1,3,6,Ocasional
6484,6,4,11820.580000000002,Cauê da Paz,4,2,4,10,VIP
6485,27,6,6951.33,Gabriela Brito,3,3,3,9,Regular
6486,1,1,487.78,Sra. Maria Helena Azevedo,4,1,1,6,Ocasional
6487,27,1,1311.47,Milena Teixeira,3,1,1,5,Ocasional
6488,74,2,894.47,Otávio Cunha,2,1,1,4,Ocasional
6489,116,5,1576.73,Lucas Gabriel Mendes,1,3,1,5,Ocasional
6490,64,4,3885.23,Diogo Brito,2,2,2,6,Ocasional
6491,56,4,3310.49,Rodrigo Pimenta,2,2,2,6,Ocasional
6493,243,3,5965.12,Brenda Alves,1,1,3,5,Ocasional
6494,35,6,7656.37,Pietro Santos,3,3,4,10,VIP
6495,262,3,6713.75,Luara Nogueira,1,1,3,5,Ocasional
6496,21,6,5425.76,Sra. Ana Luiza Montenegro,3,3,3,9,Regular
6497,23,5,7401.47,Danilo Sales,3,3,4,10,VIP
6498,54,5,15343.95,Caleb Moreira,2,3,4,9,Regular
6499,55,1,348.06,Dra. Juliana Andrade,2,1,1,4,Ocasional
6500,16,4,3270.8199999999997,Lucas Gabriel Ribeiro,4,2,2,8,Regular
6501,34,3,3535.72,Luara Vasconcelos,3,1,2,6,Ocasional
6502,6,3,2325.17,Maria Julia Martins,4,1,2,7,Regular
6503,49,6,14859.56,Sr. Davi Lucca Rocha,2,3,4,9,Regular
6504,181,2,590.9300000000001,Liz Aragão,1,1,1,3,Inativo
6505,53,6,4438.81,Apollo Moreira,2,3,3,8,Regular
6506,24,2,367.05,Sofia Lima,3,1,1,5,Ocasional
6507,42,4,3140.0299999999997,Sr. Thomas Machado,3,2,2,7,Regular
6508,78,5,3694.3699999999994,Maria Fernanda Cassiano,2,3,2,7,Regular
6509,21,10,10849.19,Maria Vitória Cassiano,3,4,4,11,VIP
6510,138,6,4192.07,Mariah Viana,1,3,2,6,Ocasional
6511,88,5,2174.26,Marcelo Silva,1,3,1,5,Ocasional
6512,20,3,4308.71,Jade Sales,3,1,2,6,Ocasional
6513,54,7,2906.67,Dra. Marcela Sampaio,2,4,2,8,Regular
6514,64,5,5476.66,Anna Liz Montenegro,2,3,3,8,Regular
6515,8,5,5387.82,Vinícius Pires,4,3,3,10,VIP
6516,33,1,492.58,Nicole Azevedo,3,1,1,5,Ocasional
6517,66,2,2779.15,Antony da Luz,2,1,2,5,Ocasional
6518,268,1,2326.95,Stella Fernandes,1,1,2,4,Ocasional
6519,1,5,2094.32,Kevin Lima,4,3,1,8,Regular
6520,13,5,2617.58,Evelyn Machado,4,3,2,9,Regular
6521,209,7,7571.400000000001,Allana Souza,1,4,4,9,Regular
6522,33,4,5303.96,Catarina Aragão,3,2,3,8,Regular
6523,20,6,8136.39,Maya da Conceição,3,3,4,10,VIP
6524,12,8,7340.34,Guilherme Campos,4,4,4,12,VIP
6525,1,9,9405.52,Sra. Sofia Cirino,4,4,4,12,VIP
6526,26,5,9210.710000000001,Cecília da Rosa,3,3,4,10,VIP
6527,24,8,9271.289999999999,Samuel Cassiano,3,4,4,11,VIP
6528,32,4,3073.26,Raul Dias,3,2,2,7,Regular
6529,56,2,3261.58,Apollo Farias,2,1,2,5,Ocasional
6530,29,5,4414.1,Ana Cecília Mendes,3,3,3,9,Regular
6531,30,9,21776.13,Ravy Brito,3,4,4,11,VIP
6532,30,6,6619.46,Alexia Abreu,3,3,3,9,Regular
6533,320,1,99.2,Rafael Costela,1,1,1,3,Inativo
6534,1,5,7845.62,Renan Silveira,4,3,4,11,VIP
6535,2,5,5176.54,Oliver Peixoto,4,3,3,10,VIP
6536,27,5,7910.34,Dra. Maria Fernanda da Costa,3,3,4,10,VIP
6537,9,6,4080.88,Olivia Almeida,4,3,2,9,Regular
6538,115,2,283.65,Maria Júlia Monteiro,1,1,1,3,Inativo
6539,8,5,5523.030000000001,Lucas Silveira,4,3,3,10,VIP
6540,21,7,3484.91,Apollo Duarte,3,4,2,9,Regular
6541,200,4,7272.6900000000005,Joaquim Farias,1,2,3,6,Ocasional
6542,7,7,8587.54,Sr. Benjamin Vargas,4,4,4,12,VIP
6543,10,4,4539.65,Ravi Mendes,4,2,3,9,Regular
6544,58,3,3292.5699999999997,Breno Viana,2,1,2,5,Ocasional
6545,36,3,911.0300000000001,Vinícius Cardoso,3,1,1,5,Ocasional
6546,12,3,8666.44,Yuri Novaes,4,1,4,9,Regular
6547,27,3,4061.93,Ágatha Nogueira,3,1,2,6,Ocasional
6548,82,4,3603.04,Sra. Olívia Novaes,2,2,2,6,Ocasional
6549,214,1,768.46,André Andrade,1,1,1,3,Inativo
6550,22,9,7068.8,Mariane Mendonça,3,4,3,10,VIP
6551,19,3,3534.12,Arthur Cirino,4,1,2,7,Regular
6552,2,5,2689.12,Daniela Vargas,4,3,2,9,Regular
6553,265,1,6479.27,Luara Ramos,1,1,3,5,Ocasional
6554,8,5,5589.43,Dr. Vinícius Costa,4,3,3,10,VIP
6555,3,5,3438.46,Srta. Clarice Duarte,4,3,2,9,Regular
6556,126,4,4883.87,Francisco da Cruz,1,2,3,6,Ocasional
6557,46,5,4426.04,Davi Luiz da Luz,2,3,3,8,Regular
6558,55,7,15921.7,Júlia Farias,2,4,4,10,VIP
6559,79,1,676.85,Bernardo Pereira,2,1,1,4,Ocasional
6560,176,3,11295.16,Bryan Sales,1,1,4,6,Ocasional
6562,1,5,1847.0,Gael Nunes,4,3,1,8,Regular
6563,118,6,4648.780000000001,Isaque Monteiro,1,3,3,7,Regular
6564,13,10,13560.71,Zoe Montenegro,4,4,4,12,VIP
6565,51,10,9283.8,Juan Nogueira,2,4,4,10,VIP
6566,80,3,833.0,Ester da Rosa,2,1,1,4,Ocasional
6567,63,4,10533.3,Evelyn Siqueira,2,2,4,8,Regular
6568,71,3,564.74,Sra. Evelyn Ramos,2,1,1,4,Ocasional
6569,31,4,3488.09,Yago Freitas,3,2,2,7,Regular
6571,59,4,7366.6,Josué Almeida,2,2,4,8,Regular
6572,34,5,5049.9,Ana Luiza Duarte,3,3,3,9,Regular
6573,106,6,4493.26,Agatha Araújo,1,3,3,7,Regular
6574,93,3,1449.76,José Pedro da Rosa,1,1,1,3,Inativo
6575,57,5,1719.71,Helena Peixoto,2,3,1,6,Ocasional
6576,2,6,10711.89,Dra. Liz Barros,4,3,4,11,VIP
6577,5,5,8040.04,Mirella Borges,4,3,4,11,VIP
6578,37,7,8362.62,Cauã Camargo,3,4,4,11,VIP
6579,32,4,3923.0,Valentina Ramos,3,2,2,7,Regular
6580,64,5,2584.55,Liam Novaes,2,3,2,7,Regular
6581,115,3,4264.33,João Gabriel Jesus,1,1,2,4,Ocasional
6582,50,2,2247.1099999999997,Luiz Otávio Sousa,2,1,1,4,Ocasional
6583,53,2,3608.6,Pedro Miguel Ribeiro,2,1,2,5,Ocasional
6584,111,6,9332.86,Bella Monteiro,1,3,4,8,Regular
6585,33,4,8751.06,Lucas Câmara,3,2,4,9,Regular
6586,8,4,3833.35,Mariane da Paz,4,2,2,8,Regular
6587,112,3,2070.8599999999997,Josué Vasconcelos,1,1,1,3,Inativo
6588,38,7,6469.19,Dr. Luiz Henrique Aragão,3,4,3,10,VIP
6589,6,3,1009.6500000000001,Hellena Moraes,4,1,1,6,Ocasional
6590,59,5,4575.0599999999995,Srta. Luiza Casa Grande,2,3,3,8,Regular
6591,85,4,3812.18,Luara Rocha,2,2,2,6,Ocasional
6592,63,6,4176.04,Pedro Henrique Peixoto,2,3,2,7,Regular
6593,60,6,4207.37,Clara Ribeiro,2,3,2,7,Regular
6594,78,7,21213.489999999998,Anna Liz Monteiro,2,4,4,10,VIP
6595,55,3,2858.1099999999997,Nicolas Lima,2,1,2,5,Ocasional
6596,43,6,3723.52,Ravi Lucca Garcia,3,3,2,8,Regular
6597,142,2,975.4399999999999,Rael Ferreira,1,1,1,3,Inativo
6598,22,6,2065.62,Juliana Araújo,3,3,1,7,Regular
6599,23,3,2756.7200000000003,Stephany Farias,3,1,2,6,Ocasional
6600,9,7,5136.0,Isadora Dias,4,4,3,11,VIP
6601,26,4,9199.560000000001,Enrico Araújo,3,2,4,9,Regular
6602,104,3,12794.2,Davi Cardoso,1,1,4,6,Ocasional
6603,182,2,4115.96,Maria Luísa Borges,1,1,2,4,Ocasional
6604,53,1,567.58,Cauã Almeida,2,1,1,4,Ocasional
6605,44,4,1761.43,Bianca Nogueira,2,2,1,5,Ocasional
6606,57,3,3454.8900000000003,Vitória da Luz,2,1,2,5,Ocasional
6607,19,5,2249.88,Bryan Ramos,4,3,1,8,Regular
6608,21,8,14411.630000000001,Ana Sophia Castro,3,4,4,11,VIP
6609,52,3,1449.12,Dr. Davi Luiz Campos,2,1,1,4,Ocasional
6610,44,4,4076.92,Isabella Pastor,2,2,2,6,Ocasional
6611,59,3,3760.08,Thales Barros,2,1,2,5,Ocasional
6612,29,5,15514.7,Laura Pereira,3,3,4,10,VIP
6613,298,1,912.73,Enzo Gabriel da Rocha,1,1,1,3,Inativo
6614,41,8,10328.07,Isis Melo,3,4,4,11,VIP
6615,72,4,6512.23,Yago Borges,2,2,3,7,Regular
6616,123,6,4468.29,João Gabriel das Neves,1,3,3,7,Regular
6617,113,4,3324.86,Leonardo Cavalcante,1,2,2,5,Ocasional
6618,33,2,1010.31,Matheus Novais,3,1,1,5,Ocasional
6619,32,3,3203.81,Olívia Porto,3,1,2,6,Ocasional
6620,15,6,10093.2,Hellena Oliveira,4,3,4,11,VIP
6621,123,2,2518.4100000000003,Letícia Camargo,1,1,2,4,Ocasional
6622,23,2,569.21,Alana da Conceição,3,1,1,5,Ocasional
6623,165,6,4650.79,Hadassa Nogueira,1,3,3,7,Regular
6624,56,3,3534.01,Alana Rodrigues,2,1,2,5,Ocasional
6625,49,2,8563.51,Murilo da Cruz,2,1,4,7,Regular
6626,57,5,10969.73,Alícia Sá,2,3,4,9,Regular
6627,34,5,4589.37,Sr. João Vitor Pastor,3,3,3,9,Regular
6628,89,4,3545.75,Raquel Alves,1,2,2,5,Ocasional
6629,103,8,9651.12,Vitor Gabriel da Costa,1,4,4,9,Regular
6630,3,5,3521.33,Lara Rezende,4,3,2,9,Regular
6631,25,4,1556.5900000000001,Isis Cunha,3,2,1,6,Ocasional
6632,171,3,4925.139999999999,João Lucas da Mota,1,1,3,5,Ocasional
6633,11,4,1643.41,Clarice Montenegro,4,2,1,7,Regular
6634,93,4,2828.05,Helena Cirino,1,2,2,5,Ocasional
6635,23,4,5177.64,Sr. Leandro Rodrigues,3,2,3,8,Regular
6636,23,3,2655.1,Diego da Paz,3,1,2,6,Ocasional
6637,20,5,3928.7599999999998,Sr. Davi Miguel Moraes,3,3,2,8,Regular
6638,14,5,12590.720000000001,Ana Carolina Alves,4,3,4,11,VIP
6639,223,4,6522.719999999999,Dr. João Gabriel Vargas,1,2,3,6,Ocasional
6640,9,7,8549.25,Enrico Vieira,4,4,4,12,VIP
6641,56,4,12068.89,Dr. Henry Monteiro,2,2,4,8,Regular
6642,193,1,129.3,Diogo Leão,1,1,1,3,Inativo
6643,48,1,821.32,Rhavi Borges,2,1,1,4,Ocasional
6644,4,5,2627.04,Maria Fernanda Fernandes,4,3,2,9,Regular
6645,222,4,2836.49,Sra. Antonella Barbosa,1,2,2,5,Ocasional
6646,11,2,9026.61,Davi Lucca Andrade,4,1,4,9,Regular
6647,2,3,1178.57,Miguel Nascimento,4,1,1,6,Ocasional
6648,280,4,8327.8,Noah da Paz,1,2,4,7,Regular
6649,13,3,4366.89,Eloá Pinto,4,1,2,7,Regular
6650,49,2,1841.84,Sr. Joaquim Casa Grande,2,1,1,4,Ocasional
6651,43,3,2394.29,Davi Lucas Araújo,3,1,2,6,Ocasional
6652,17,5,9530.83,Maria Júlia Pereira,4,3,4,11,VIP
6653,47,3,4882.400000000001,Sra. Laís Sampaio,2,1,3,6,Ocasional
6654,12,6,7781.0599999999995,Olivia Novais,4,3,4,11,VIP
6655,46,3,4241.96,Agatha Costa,2,1,2,5,Ocasional
6656,165,4,7317.29,Lorena Ribeiro,1,2,3,6,Ocasional
6657,22,8,8139.12,Luiz Otávio Cunha,3,4,4,11,VIP
6658,44,2,2108.55,Clara da Costa,2,1,1,4,Ocasional
6659,89,4,7902.08,Clara Souza,1,2,4,7,Regular
6660,31,7,13737.0,Calebe Fonseca,3,4,4,11,VIP
6661,220,1,117.29,João Miguel Rocha,1,1,1,3,Inativo
6662,263,1,2134.84,Cauã Andrade,1,1,1,3,Inativo
6663,11,9,14915.32,Dra. Lara Carvalho,4,4,4,12,VIP
6664,58,5,2953.23,Emanuelly Ramos,2,3,2,7,Regular
6665,13,4,3666.3,Maria Fernanda Aparecida,4,2,2,8,Regular
6667,91,2,668.5799999999999,Dra. Maria Isis Câmara,1,1,1,3,Inativo
6668,26,5,4721.95,Dr. Marcelo Nogueira,3,3,3,9,Regular
6669,3,6,13288.01,Théo Pimenta,4,3,4,11,VIP
6670,36,4,7435.1900000000005,Giovanna da Conceição,3,2,4,9,Regular
6671,9,7,13405.42,Diego Leão,4,4,4,12,VIP
6672,63,5,2505.67,Maitê Sá,2,3,2,7,Regular
6673,51,2,2475.28,Joana da Costa,2,1,2,5,Ocasional
6674,192,3,6345.33,Gabriela Sampaio,1,1,3,5,Ocasional
6675,114,7,4098.93,Dom Gonçalves,1,4,2,7,Regular
6676,27,3,8185.57,Mariane Camargo,3,1,4,8,Regular
6677,268,1,500.52,Mirella Garcia,1,1,1,3,Inativo
6678,146,5,8916.75,Ana Cecília Cirino,1,3,4,8,Regular
6679,85,4,3794.37,Dr. Levi Martins,2,2,2,6,Ocasional
6680,51,5,11848.79,Gael Mendonça,2,3,4,9,Regular
6681,91,2,1014.56,Isaac Mendonça,1,1,1,3,Inativo
6682,32,7,9325.029999999999,Sr. Bernardo Rezende,3,4,4,11,VIP
6683,57,2,4927.58,Evelyn Aparecida,2,1,3,6,Ocasional
6685,90,5,5365.04,Fernando da Cruz,1,3,3,7,Regular
6686,103,3,4270.85,Ryan Campos,1,1,2,4,Ocasional
6687,65,4,2030.44,Yago Aragão,2,2,1,5,Ocasional
6688,77,3,3120.4700000000003,Ana Beatriz Rios,2,1,2,5,Ocasional
6689,15,8,12675.15,Renan Costa,4,4,4,12,VIP
6690,103,2,1056.3,Isaac Novais,1,1,1,3,Inativo
6691,88,6,14464.29,Manuela da Mata,1,3,4,8,Regular
6692,172,4,4704.6,Théo Rezende,1,2,3,6,Ocasional
6693,8,7,7511.429999999999,Matteo Cassiano,4,4,4,12,VIP
6694,121,3,3458.9900000000002,Sara Andrade,1,1,2,4,Ocasional
6695,61,5,6003.75,Melina Lopes,2,3,3,8,Regular
6696,55,5,5131.53,Sr. Benício Pacheco,2,3,3,8,Regular
6697,30,5,3176.29,Sr. Francisco Vieira,3,3,2,8,Regular
6698,6,8,10559.37,Dr. Lucas Gabriel Machado,4,4,4,12,VIP
6699,228,5,9984.91,Ana Carolina Lopes,1,3,4,8,Regular
6700,35,4,6282.43,Mateus Barros,3,2,3,8,Regular
6701,179,4,4313.33,Lorenzo Vieira,1,2,2,5,Ocasional
6702,93,5,12393.95,Jade da Mota,1,3,4,8,Regular
6703,4,4,11621.95,Sr. Thiago Jesus,4,2,4,10,VIP
6704,6,5,1223.47,Raquel Sales,4,3,1,8,Regular
6705,2,9,6796.219999999999,Beatriz Carvalho,4,4,3,11,VIP
6706,36,4,7491.88,Diogo da Luz,3,2,4,9,Regular
6707,25,5,7051.39,Luísa Andrade,3,3,3,9,Regular
6708,83,5,1473.6100000000001,Melissa Vargas,2,3,1,6,Ocasional
6709,61,7,9582.68,Ana Barros,2,4,4,10,VIP
6710,14,7,5737.81,Dr. Luiz Felipe Azevedo,4,4,3,11,VIP
6711,171,1,400.83,Mateus Caldeira,1,1,1,3,Inativo
6712,46,2,988.66,Manuella Campos,2,1,1,4,Ocasional
6713,12,3,4502.77,Marcos Vinicius da Conceição,4,1,3,8,Regular
6714,73,2,1111.69,Caleb Machado,2,1,1,4,Ocasional
6715,14,6,9541.699999999999,Dr. Bernardo Pacheco,4,3,4,11,VIP
6716,4,4,4214.09,Srta. Ayla Vasconcelos,4,2,2,8,Regular
6717,215,1,1709.25,Eduarda Pinto,1,1,1,3,Inativo
6718,96,2,4680.98,Henrique Campos,1,1,3,5,Ocasional
6719,207,6,4802.2,Rodrigo Pacheco,1,3,3,7,Regular
6720,25,5,2949.7,Heloísa Barros,3,3,2,8,Regular
6721,60,5,6606.37,Dr. Joaquim Sá,2,3,3,8,Regular
6722,45,4,2150.1800000000003,Giovanna Nascimento,2,2,1,5,Ocasional
6723,311,1,1919.0,Anna Liz da Luz,1,1,1,3,Inativo
6724,128,1,333.86,Carlos Eduardo Nascimento,1,1,1,3,Inativo
6725,13,2,2023.62,Benjamin Barros,4,1,1,6,Ocasional
6726,62,4,2867.35,Ravi da Costa,2,2,2,6,Ocasional
6727,92,6,8125.9400000000005,Rafael Mendonça,1,3,4,8,Regular
6728,63,2,543.5699999999999,Sr. Lucas Gabriel Lima,2,1,1,4,Ocasional
6730,4,4,9355.99,Luísa da Luz,4,2,4,10,VIP
6731,7,5,4541.93,Brenda da Mota,4,3,3,10,VIP
6732,33,7,4819.36,Juan Rocha,3,4,3,10,VIP
6733,155,4,2897.52,Maria Sophia Vasconcelos,1,2,2,5,Ocasional
6734,64,3,5355.16,Emanuel Araújo,2,1,3,6,Ocasional
6735,106,5,7380.61,Bruna Pereira,1,3,4,8,Regular
6736,12,8,11635.08,Yago Leão,4,4,4,12,VIP
6737,11,4,8704.869999999999,Eloá Ferreira,4,2,4,10,VIP
6738,56,6,1834.5,Sra. Ana Vitória Ribeiro,2,3,1,6,Ocasional
6739,107,4,2219.9300000000003,Aylla Cunha,1,2,1,4,Ocasional
6740,3,6,8783.52,Srta. Ana Laura Pastor,4,3,4,11,VIP
6741,62,4,4297.25,Thomas Melo,2,2,2,6,Ocasional
6742,37,3,1084.06,Ísis Camargo,3,1,1,5,Ocasional
6743,110,4,5291.01,Matteo Costa,1,2,3,6,Ocasional
6744,35,3,524.09,Vitor Gabriel Santos,3,1,1,5,Ocasional
6745,51,3,819.7900000000001,Noah Azevedo,2,1,1,4,Ocasional
6746,158,2,2339.08,Davi Luiz Jesus,1,1,2,4,Ocasional
6747,26,3,3284.4400000000005,João Gabriel Moreira,3,1,2,6,Ocasional
6748,23,5,5440.030000000001,Sr. Thales Nunes,3,3,3,9,Regular
6749,154,1,632.62,Maria Sophia Leão,1,1,1,3,Inativo
6750,136,6,13771.0,Srta. Kamilly Alves,1,3,4,8,Regular
6751,7,7,7204.579999999999,Dra. Larissa Correia,4,4,3,11,VIP
6752,31,2,2313.87,Isadora Oliveira,3,1,2,6,Ocasional
6753,94,3,679.02,Pedro Miguel Mendes,1,1,1,3,Inativo
6754,38,5,1500.36,Daniel Abreu,3,3,1,7,Regular
6755,49,5,14366.460000000001,Benício Barbosa,2,3,4,9,Regular
6756,39,4,3145.73,Nicole Leão,3,2,2,7,Regular
6757,47,4,9418.64,Clara Campos,2,2,4,8,Regular
6758,89,5,3216.31,Srta. Maria Luiza Sousa,1,3,2,6,Ocasional
6759,85,3,2634.88,Esther Rocha,2,1,2,5,Ocasional
6760,133,5,3018.2400000000002,Dra. Emilly Dias,1,3,2,6,Ocasional
6761,11,3,5245.879999999999,Gustavo Castro,4,1,3,8,Regular
6762,18,4,11031.539999999999,Isaac Ribeiro,4,2,4,10,VIP
6763,11,7,6766.96,Melina da Rosa,4,4,3,11,VIP
6764,59,7,4287.9800000000005,Rafaela Caldeira,2,4,2,8,Regular
6765,11,7,9928.47,Samuel Machado,4,4,4,12,VIP
6766,47,6,4712.79,Gabrielly Sá,2,3,3,8,Regular
6767,34,4,2491.91,Isadora Vasconcelos,3,2,2,7,Regular
6768,96,6,12183.36,Mirella Nunes,1,3,4,8,Regular
6769,9,5,6795.759999999999,Ayla Sá,4,3,3,10,VIP
6770,29,5,7049.379999999999,Valentina Azevedo,3,3,3,9,Regular
6771,69,5,5174.08,Emanuella Jesus,2,3,3,8,Regular
6772,22,6,4452.72,Rael Barbosa,3,3,3,9,Regular
6773,9,3,2169.3,Raul Câmara,4,1,1,6,Ocasional
6774,158,3,4079.91,Joana Casa Grande,1,1,2,4,Ocasional
6775,113,4,5465.389999999999,Lorenzo da Rosa,1,2,3,6,Ocasional
6776,43,4,6526.54,Isadora Melo,3,2,3,8,Regular
6777,105,5,2920.84,Carolina Teixeira,1,3,2,6,Ocasional
6778,77,10,12479.27,Henrique Silva,2,4,4,10,VIP
6779,95,5,2462.67,Emanuel Campos,1,3,2,6,Ocasional
6780,8,4,4521.360000000001,Srta. Vitória Silva,4,2,3,9,Regular
6781,190,3,4380.46,Hadassa Mendonça,1,1,3,5,Ocasional
6782,235,2,2730.59,Enrico Lopes,1,1,2,4,Ocasional
6783,30,6,8156.17,Guilherme Fernandes,3,3,4,10,VIP
6784,14,9,14169.07,Ana Sophia Sampaio,4,4,4,12,VIP
6785,94,4,5422.96,Dra. Lorena Moreira,1,2,3,6,Ocasional
6786,14,4,5218.139999999999,Murilo Guerra,4,2,3,9,Regular
6787,11,5,5872.41,Kevin Farias,4,3,3,10,VIP
6788,5,5,4438.160000000001,Joana Vieira,4,3,3,10,VIP
6789,15,4,9930.8,Sr. Gustavo Ramos,4,2,4,10,VIP
6790,12,7,7307.64,Dr. Gustavo Henrique Cassiano,4,4,3,11,VIP
6791,4,4,5403.929999999999,João Miguel Araújo,4,2,3,9,Regular
6792,77,4,2488.74,Sra. Valentina Mendes,2,2,2,6,Ocasional
6793,63,5,3728.4900000000002,Dr. Leandro Aparecida,2,3,2,7,Regular
6794,42,5,5612.66,Luiza Rocha,3,3,3,9,Regular
6795,13,8,13265.269999999999,Maria Eduarda Almeida,4,4,4,12,VIP
6796,169,3,454.97,Emilly Brito,1,1,1,3,Inativo
6797,58,6,3234.3100000000004,Gael Henrique Guerra,2,3,2,7,Regular
6799,10,4,2882.2400000000002,Eduarda Leão,4,2,2,8,Regular
6800,6,4,4648.84,Ana Luiza da Rosa,4,2,3,9,Regular
6801,27,4,1694.27,Bruna Sales,3,2,1,6,Ocasional
6802,48,5,12594.61,Caleb Cavalcante,2,3,4,9,Regular
6803,164,3,11710.83,Ana Sophia Nascimento,1,1,4,6,Ocasional
6804,81,4,3342.43,Vitor Hugo Aragão,2,2,2,6,Ocasional
6805,12,4,10352.57,Rafaela Brito,4,2,4,10,VIP
6806,13,8,4772.66,Benício Cassiano,4,4,3,11,VIP
6807,12,4,6763.099999999999,Maria Vitória Guerra,4,2,3,9,Regular
6808,7,7,4418.53,Alexandre Santos,4,4,3,11,VIP
6809,34,1,391.65,Davi Lucca Alves,3,1,1,5,Ocasional
6810,15,5,2297.18,Dom Martins,4,3,2,9,Regular
6811,66,5,6613.98,Vicente Nascimento,2,3,3,8,Regular
6812,26,5,5025.43,Amanda Santos,3,3,3,9,Regular
6813,32,8,8115.48,Dr. Matheus da Mota,3,4,4,11,VIP
6814,50,2,1178.92,Kevin da Luz,2,1,1,4,Ocasional
6815,153,4,3675.2,Yago Fernandes,1,2,2,5,Ocasional
6816,35,7,9765.83,Dr. Davi Miguel Moura,3,4,4,11,VIP
6817,61,4,1820.8899999999999,Paulo Aparecida,2,2,1,5,Ocasional
6818,78,3,6771.95,Dra. Maya Borges,2,1,3,6,Ocasional
6819,52,2,716.1700000000001,Joana Pires,2,1,1,4,Ocasional
6820,90,1,167.44,Theo Martins,1,1,1,3,Inativo
6821,62,6,4403.54,Larissa Monteiro,2,3,3,8,Regular
6822,80,4,2672.2799999999997,Sophia Vieira,2,2,2,6,Ocasional
6823,74,1,42.9,Luiz Henrique Garcia,2,1,1,4,Ocasional
6824,131,3,3608.0699999999997,Srta. Ana Laura da Conceição,1,1,2,4,Ocasional
6825,20,4,5640.36,João Guilherme Jesus,3,2,3,8,Regular
6826,146,4,7180.780000000001,Laís Borges,1,2,3,6,Ocasional
6827,47,9,12889.27,Maya Monteiro,2,4,4,10,VIP
6828,83,5,7794.209999999999,Ana Carolina Costa,2,3,4,9,Regular
6829,38,2,2005.11,Manuela Monteiro,3,1,1,5,Ocasional
6830,8,5,11685.869999999999,Lara da Cruz,4,3,4,11,VIP
6831,24,4,2465.09,Maitê Costela,3,2,2,7,Regular
6832,43,3,2680.55,José Rocha,3,1,2,6,Ocasional
6833,135,1,70.24,Maria Aragão,1,1,1,3,Inativo
6834,208,1,2170.92,Sra. Mariana Freitas,1,1,1,3,Inativo
6835,6,5,4434.67,Isadora Pinto,4,3,3,10,VIP
6836,35,2,994.52,Caleb Melo,3,1,1,5,Ocasional
6837,74,4,6169.59,Sra. Lavínia Castro,2,2,3,7,Regular
6838,43,3,2769.07,Eduarda Lopes,3,1,2,6,Ocasional
6839,23,2,4803.8099999999995,Maria Eduarda Fonseca,3,1,3,7,Regular
6840,43,3,5742.5,Stephany Vargas,3,1,3,7,Regular
6841,119,4,4219.98,Maria Alice Garcia,1,2,2,5,Ocasional
6842,37,5,2179.71,Eduardo Carvalho,3,3,1,7,Regular
6843,53,4,8954.82,Eduardo Azevedo,2,2,4,8,Regular
6844,111,5,3418.37,Benjamin da Cruz,1,3,2,6,Ocasional
6845,85,5,6219.960000000001,Eduardo Fonseca,2,3,3,8,Regular
6846,2,5,7694.5,Bruno Rios,4,3,4,11,VIP
6847,148,5,7047.280000000001,Sophia Correia,1,3,3,7,Regular
6848,229,2,2549.6099999999997,Camila Pires,1,1,2,4,Ocasional
6849,33,6,3552.66,Henry Gabriel Sousa,3,3,2,8,Regular
6850,81,3,5552.26,Sr. Vitor da Luz,2,1,3,6,Ocasional
6851,44,8,15331.7,Isadora Ramos,2,4,4,10,VIP
6852,37,5,19925.77,Ester Câmara,3,3,4,10,VIP
6853,49,5,4387.87,Theodoro Oliveira,2,3,3,8,Regular
6854,2,4,4145.79,Dom Dias,4,2,2,8,Regular
6855,170,3,9822.869999999999,Ana Luiza Garcia,1,1,4,6,Ocasional
6856,72,2,125.78,Dra. Maria Luiza Carvalho,2,1,1,4,Ocasional
6857,31,5,11359.08,Dr. Carlos Eduardo Siqueira,3,3,4,10,VIP
6858,43,6,4960.43,Marcela Viana,3,3,3,9,Regular
6859,28,6,4094.0499999999997,Diogo Sousa,3,3,2,8,Regular
6860,11,4,1924.41,Mariah Carvalho,4,2,1,7,Regular
6861,16,8,7195.900000000001,Stella Porto,4,4,3,11,VIP
6862,202,3,3141.5099999999998,Benjamin Macedo,1,1,2,4,Ocasional
6863,5,1,305.04,Arthur Miguel da Mota,4,1,1,6,Ocasional
6864,64,4,7085.8,Ana Vitória Dias,2,2,3,7,Regular
6865,19,5,7476.429999999999,Giovanna Gomes,4,3,4,11,VIP
6866,72,2,1386.26,Cecília Albuquerque,2,1,1,4,Ocasional
6867,162,1,1715.63,Aurora Jesus,1,1,1,3,Inativo
6868,61,4,954.71,Gustavo Henrique Cardoso,2,2,1,5,Ocasional
6869,20,3,1486.4,Ryan Albuquerque,3,1,1,5,Ocasional
6870,52,3,5014.610000000001,Sophie Castro,2,1,3,6,Ocasional
6871,23,6,8322.49,Thales Moraes,3,3,4,10,VIP
6872,63,5,3693.63,Vitor Hugo Gonçalves,2,3,2,7,Regular
6873,25,5,4793.51,Esther Macedo,3,3,3,9,Regular
6874,6,3,7273.86,José Rodrigues,4,1,3,8,Regular
6875,30,8,11666.0,Valentina Casa Grande,3,4,4,11,VIP
6876,24,7,4650.9400000000005,Leandro Aragão,3,4,3,10,VIP
6877,8,5,5406.57,João Gabriel Nascimento,4,3,3,10,VIP
6878,13,5,3650.76,Theodoro Nascimento,4,3,2,9,Regular
6879,24,3,2501.27,Ana Liz Pastor,3,1,2,6,Ocasional
6880,57,6,4093.35,Renan Fogaça,2,3,2,7,Regular
6881,99,2,597.55,Dr. Davi Miguel Duarte,1,1,1,3,Inativo
6882,159,2,275.25,Erick Melo,1,1,1,3,Inativo
6883,14,4,1224.13,Sr. Nathan Costela,4,2,1,7,Regular
6884,115,3,11377.49,Matheus Almeida,1,1,4,6,Ocasional
6885,66,3,5091.45,Bruna Macedo,2,1,3,6,Ocasional
6886,127,3,2432.9700000000003,Stella Albuquerque,1,1,2,4,Ocasional
6887,48,1,1491.14,Enrico Nunes,2,1,1,4,Ocasional
6888,5,4,5138.13,Sra. Gabrielly Nascimento,4,2,3,9,Regular
6889,20,5,5658.92,Enzo Gabriel Machado,3,3,3,9,Regular
6890,47,4,3637.9700000000003,Sr. Henry Peixoto,2,2,2,6,Ocasional
6891,17,4,2431.56,Bárbara Moreira,4,2,2,8,Regular
6892,61,10,9716.14,Daniel Guerra,2,4,4,10,VIP
6893,57,3,2979.41,Lorena Ramos,2,1,2,5,Ocasional
6894,45,4,1341.49,Letícia Duarte,2,2,1,5,Ocasional
6895,196,2,720.38,Antônio Fonseca,1,1,1,3,Inativo
6896,234,1,1165.36,Daniela Leão,1,1,1,3,Inativo
6897,42,4,6161.22,Nicolas Viana,3,2,3,8,Regular
6898,1,7,14212.98,Rebeca Pimenta,4,4,4,12,VIP
6899,196,1,2493.95,Ana Costa,1,1,2,4,Ocasional
6900,49,2,1576.76,João Vitor Almeida,2,1,1,4,Ocasional
6901,197,3,2942.38,Benjamin Castro,1,1,2,4,Ocasional
6902,117,5,6982.96,Isadora da Cruz,1,3,3,7,Regular
6903,208,2,3792.35,Antonella Souza,1,1,2,4,Ocasional
6904,13,6,11665.14,Sra. Eduarda Melo,4,3,4,11,VIP
6905,14,6,4320.58,José Miguel Campos,4,3,2,9,Regular
6906,243,1,655.98,Marcos Vinicius Rezende,1,1,1,3,Inativo
6907,14,4,1580.4699999999998,Dr. Theodoro Cirino,4,2,1,7,Regular
6908,43,2,1982.2600000000002,Marcos Vinicius Brito,3,1,1,5,Ocasional
6909,48,4,7937.24,Olivia Pereira,2,2,4,8,Regular
6910,15,5,5404.860000000001,Sra. Maysa Macedo,4,3,3,10,VIP
6911,49,4,4320.9400000000005,Ana Liz Campos,2,2,2,6,Ocasional
6912,26,3,7398.37,Dr. Davi Luiz da Luz,3,1,4,8,Regular
6913,5,5,25606.260000000002,Ayla Novais,4,3,4,11,VIP
6914,32,4,7130.82,Benicio Pastor,3,2,3,8,Regular
6915,35,6,8434.310000000001,Olivia da Mata,3,3,4,10,VIP
6916,16,1,2455.76,Cauã Lopes,4,1,2,7,Regular
6917,138,5,10406.39,Ana Nogueira,1,3,4,8,Regular
6918,116,5,5268.17,Vicente Oliveira,1,3,3,7,Regular
6919,49,3,1474.52,Maria Isis da Conceição,2,1,1,4,Ocasional
6920,100,2,3878.24,Eduarda Gomes,1,1,2,4,Ocasional
6921,65,4,2835.79,Théo Carvalho,2,2,2,6,Ocasional
6922,104,3,1042.06,Benicio Azevedo,1,1,1,3,Inativo
6923,44,3,2072.16,Sr. Luigi Novais,2,1,1,4,Ocasional
6924,30,3,5154.67,Melissa Vasconcelos,3,1,3,7,Regular
6925,36,4,3187.7200000000003,João Vitor da Conceição,3,2,2,7,Regular
6926,121,5,10209.220000000001,Stella Santos,1,3,4,8,Regular
6927,34,7,10998.23,Sra. Clarice Rios,3,4,4,11,VIP
6928,2,6,9281.59,Arthur Gabriel Aragão,4,3,4,11,VIP
6929,58,4,3898.67,Levi Silva,2,2,2,6,Ocasional
6930,34,5,4659.3099999999995,Anna Liz Castro,3,3,3,9,Regular
6931,96,3,1465.15,Dom Sampaio,1,1,1,3,Inativo
6932,12,4,5426.38,Clarice Monteiro,4,2,3,9,Regular
6933,56,8,8448.84,Olivia da Luz,2,4,4,10,VIP
6934,48,5,4714.84,Sr. Pedro Henrique Rocha,2,3,3,8,Regular
6935,21,6,10041.58,André Andrade,3,3,4,10,VIP
6936,77,3,2710.49,Rodrigo Silveira,2,1,2,5,Ocasional
6937,65,3,5534.26,Maria Cecília Pereira,2,1,3,6,Ocasional
6938,41,7,6290.73,José Novaes,3,4,3,10,VIP
6939,15,5,6162.95,Miguel Costa,4,3,3,10,VIP
6940,34,6,13892.69,Isabelly Nogueira,3,3,4,10,VIP
6941,4,5,4506.22,Ana Vitória Carvalho,4,3,3,10,VIP
6942,47,2,1024.21,Alana da Cunha,2,1,1,4,Ocasional
6943,29,3,4577.62,Sr. Lucas Aragão,3,1,3,7,Regular
6944,24,3,6513.58,Dra. Isabelly Novaes,3,1,3,7,Regular
6945,17,5,10669.869999999999,Heloísa Duarte,4,3,4,11,VIP
6946,6,5,7568.07,Zoe Albuquerque,4,3,4,11,VIP
6947,196,2,726.01,Ravi Costa,1,1,1,3,Inativo
6948,26,5,5953.23,Pietra Araújo,3,3,3,9,Regular
6949,3,5,7899.25,Júlia Macedo,4,3,4,11,VIP
6950,108,4,5943.7,Thomas Almeida,1,2,3,6,Ocasional
6951,14,3,2859.1,João Gabriel Pastor,4,1,2,7,Regular
6952,38,8,14921.49,Dr. Pietro Cunha,3,4,4,11,VIP
6953,18,4,4551.49,Otávio Cavalcante,4,2,3,9,Regular
6954,70,4,2405.1800000000003,Davi Luiz Barbosa,2,2,2,6,Ocasional
6955,166,1,500.49,Ravy Albuquerque,1,1,1,3,Inativo
6956,170,2,1683.82,Manuela Sousa,1,1,1,3,Inativo
6957,84,4,5469.21,Sr. Leonardo Albuquerque,2,2,3,7,Regular
6958,203,2,774.13,Asafe Rodrigues,1,1,1,3,Inativo
6959,2,5,7112.17,Henry Gabriel Pastor,4,3,3,10,VIP
6960,88,4,1207.29,Henry Gabriel Pimenta,1,2,1,4,Ocasional
6961,35,5,4625.7,Emilly Mendes,3,3,3,9,Regular
6962,76,1,2510.74,Noah Costa,2,1,2,5,Ocasional
6963,51,4,2427.7,Esther Fernandes,2,2,2,6,Ocasional
6964,41,3,5166.37,Lorenzo Albuquerque,3,1,3,7,Regular
6965,47,6,2210.96,Guilherme Rezende,2,3,1,6,Ocasional
6966,75,2,3100.5499999999997,Raquel Pereira,2,1,2,5,Ocasional
6967,4,1,1829.1,Daniel Albuquerque,4,1,1,6,Ocasional
6968,64,5,10921.25,Anthony Cavalcanti,2,3,4,9,Regular
6969,53,2,3173.02,Benicio da Rosa,2,1,2,5,Ocasional
6970,26,2,3361.63,José Pedro Castro,3,1,2,6,Ocasional
6971,38,4,2732.78,Sr. Isaac Casa Grande,3,2,2,7,Regular
6972,5,4,4198.78,Emanuel Gomes,4,2,2,8,Regular
6973,10,7,6675.94,Srta. Amanda Nunes,4,4,3,11,VIP
6974,14,4,2320.75,Olivia Moreira,4,2,2,8,Regular
6975,66,2,1909.71,Evelyn da Cunha,2,1,1,4,Ocasional
6976,266,1,593.58,Alexia Campos,1,1,1,3,Inativo
6977,82,2,616.0,Sr. Henry Ramos,2,1,1,4,Ocasional
6978,30,5,4706.59,Srta. Maria Vitória Novais,3,3,3,9,Regular
6979,107,2,3676.33,Camila Sampaio,1,1,2,4,Ocasional
6980,29,8,28867.059999999998,Dr. João Pedro Andrade,3,4,4,11,VIP
6981,8,4,5465.03,Antony Moreira,4,2,3,9,Regular
6982,39,4,3782.1,Sara da Conceição,3,2,2,7,Regular
6983,26,10,16332.83,Gael Henrique Pereira,3,4,4,11,VIP
6984,110,4,3802.9,Renan das Neves,1,2,2,5,Ocasional
6985,6,7,6999.29,Heloísa Fonseca,4,4,3,11,VIP
6986,27,4,3813.6899999999996,Ravy Porto,3,2,2,7,Regular
6987,32,3,5293.5,Davi Miguel Cirino,3,1,3,7,Regular
6988,21,5,3549.1400000000003,Cecilia Moura,3,3,2,8,Regular
6989,25,7,10830.84,Luiz Gustavo Carvalho,3,4,4,11,VIP
6990,89,4,2132.59,Sabrina Melo,1,2,1,4,Ocasional
6991,130,4,13824.55,Rafaela Melo,1,2,4,7,Regular
6992,2,6,8365.69,Dra. Olivia Castro,4,3,4,11,VIP
6993,37,7,3326.26,Miguel Pereira,3,4,2,9,Regular
6994,63,4,2307.6400000000003,Zoe Lopes,2,2,2,6,Ocasional
6996,35,2,726.9399999999999,Daniel Andrade,3,1,1,5,Ocasional
6997,9,3,1715.96,Bernardo Gonçalves,4,1,1,6,Ocasional
6998,1,6,2985.07,Ana Sophia Rios,4,3,2,9,Regular
6999,16,3,1022.1199999999999,Ana Vitória Lima,4,1,1,6,Ocasional
7000,154,3,2032.3,Bryan Nogueira,1,1,1,3,Inativo
7002,8,10,11222.74,Renan Pimenta,4,4,4,12,VIP
7003,59,5,8592.19,Gael Henrique Alves,2,3,4,9,Regular
7004,91,3,888.1000000000001,Isabelly Campos,1,1,1,3,Inativo
7005,140,3,251.96,Luiz Henrique Gomes,1,1,1,3,Inativo
7006,13,4,3995.7799999999997,Sra. Ana Laura Pastor,4,2,2,8,Regular
7007,71,5,2151.0899999999997,José Miguel da Rosa,2,3,1,6,Ocasional
7008,49,2,1052.66,Maria Julia Albuquerque,2,1,1,4,Ocasional
7009,53,4,3723.34,Luiza Ramos,2,2,2,6,Ocasional
7010,125,3,1470.48,Dr. Davi Almeida,1,1,1,3,Inativo
7011,1,7,22547.46,Erick Lima,4,4,4,12,VIP
7012,5,5,8949.380000000001,Augusto Cassiano,4,3,4,11,VIP
7013,26,5,2311.23,Sr. Gustavo da Rosa,3,3,2,8,Regular
7014,1,3,3093.0699999999997,Miguel Santos,4,1,2,7,Regular
7015,28,7,7071.38,José Pedro Fogaça,3,4,3,10,VIP
7016,17,6,9988.84,Luiz Fernando Alves,4,3,4,11,VIP
7017,65,2,4159.19,Camila Borges,2,1,2,5,Ocasional
7018,1,2,312.53000000000003,Esther Guerra,4,1,1,6,Ocasional
7019,291,1,2600.38,Olivia Pereira,1,1,2,4,Ocasional
7020,31,7,5514.24,Maria Isis Ribeiro,3,4,3,10,VIP
7021,8,6,8002.289999999999,Srta. Evelyn Sales,4,3,4,11,VIP
7022,133,5,6354.91,Brayan Vargas,1,3,3,7,Regular
7023,24,3,4743.650000000001,Isabela Marques,3,1,3,7,Regular
7024,9,6,14197.24,Pietra Vargas,4,3,4,11,VIP
7025,116,1,2014.41,Luiz Henrique Casa Grande,1,1,1,3,Inativo
7026,8,7,5146.62,Beatriz Pimenta,4,4,3,11,VIP
7027,2,5,9307.4,Gustavo Campos,4,3,4,11,VIP
7028,60,6,14824.59,Natália Correia,2,3,4,9,Regular
7029,52,4,2938.57,Maria Eduarda Mendes,2,2,2,6,Ocasional
7030,126,3,6460.8099999999995,Lucas Castro,1,1,3,5,Ocasional
7031,33,9,4472.77,Sara Silva,3,4,3,10,VIP
7032,37,4,6087.38,Davi Lucca Viana,3,2,3,8,Regular
7033,42,5,4745.76,Matteo Costa,3,3,3,9,Regular
7034,40,4,6443.0,Sr. Luigi Sá,3,2,3,8,Regular
7035,190,6,4432.98,Thomas Nascimento,1,3,3,7,Regular
7036,8,7,7698.31,Cauê Peixoto,4,4,4,12,VIP
7037,187,2,699.4399999999999,Josué Cavalcante,1,1,1,3,Inativo
7038,196,1,3949.18,Sr. Vinícius Pereira,1,1,2,4,Ocasional
7039,60,4,12302.92,Sr. Ravi Lucca Teixeira,2,2,4,8,Regular
7040,56,9,8962.59,Maria Clara Jesus,2,4,4,10,VIP
7041,21,9,12071.34,Dra. Maria Cecília Gomes,3,4,4,11,VIP
7042,89,5,2002.83,Helena Sales,1,3,1,5,Ocasional
7043,4,5,10381.89,Caleb Montenegro,4,3,4,11,VIP
7044,42,6,3012.4300000000003,Luiz Otávio Nascimento,3,3,2,8,Regular
7045,27,4,1939.2,Heloisa Ferreira,3,2,1,6,Ocasional
7046,6,2,961.78,Allana Lopes,4,1,1,6,Ocasional
7047,58,7,11293.84,Eloah Guerra,2,4,4,10,VIP
7048,45,6,7891.67,Ana Liz Viana,2,3,4,9,Regular
7049,42,5,3897.1000000000004,Srta. Marina Mendonça,3,3,2,8,Regular
7050,69,4,5219.33,Sra. Hadassa Campos,2,2,3,7,Regular
7051,13,2,829.81,Isabella Azevedo,4,1,1,6,Ocasional
7052,39,6,3768.52,Carolina Ribeiro,3,3,2,8,Regular
7053,53,8,11665.14,Isabelly Dias,2,4,4,10,VIP
7054,47,3,3556.54,Cecilia da Cunha,2,1,2,5,Ocasional
7055,30,5,6991.599999999999,Mariana Costela,3,3,3,9,Regular
7056,11,7,6863.7,Anthony Cirino,4,4,3,11,VIP
7057,116,3,1569.94,Isabelly Sales,1,1,1,3,Inativo
7058,61,5,8318.91,Yan Pastor,2,3,4,9,Regular
7059,16,4,1189.87,Manuela Novais,4,2,1,7,Regular
7060,13,2,3034.81,Hellena Machado,4,1,2,7,Regular
7061,19,7,12157.92,João Vitor da Conceição,4,4,4,12,VIP
7062,80,3,1866.8,Heloisa Correia,2,1,1,4,Ocasional
7063,52,6,8120.95,Thiago das Neves,2,3,4,9,Regular
7064,72,6,11708.41,Mathias Martins,2,3,4,9,Regular
7065,50,3,5352.0599999999995,Matheus Ferreira,2,1,3,6,Ocasional
7066,75,4,3032.8100000000004,Emilly Cunha,2,2,2,6,Ocasional
7067,73,2,2722.7,Sr. Yan Leão,2,1,2,5,Ocasional
7068,72,1,65.23,Sra. Carolina Caldeira,2,1,1,4,Ocasional
7069,173,3,2669.6,Sofia Carvalho,1,1,2,4,Ocasional
7070,2,9,14571.43,Lucas Jesus,4,4,4,12,VIP
7071,31,7,11712.26,Milena Dias,3,4,4,11,VIP
7072,14,7,5709.38,Gael Gonçalves,4,4,3,11,VIP
7073,176,1,493.09,Alexandre Almeida,1,1,1,3,Inativo
7074,13,3,7315.9400000000005,Sra. Eloá Gonçalves,4,1,3,8,Regular
7075,1,8,9935.33,Luiz Miguel Oliveira,4,4,4,12,VIP
7076,13,3,9641.43,Francisco da Cunha,4,1,4,9,Regular
7077,49,4,625.27,Luara Pimenta,2,2,1,5,Ocasional
7078,48,6,6811.15,Maria Fernanda Garcia,2,3,3,8,Regular
7079,81,3,4265.4,Sophia Pastor,2,1,2,5,Ocasional
7080,2,6,4892.5599999999995,Luiz Henrique Carvalho,4,3,3,10,VIP
7081,5,6,5514.12,Ana Carolina Ribeiro,4,3,3,10,VIP
7082,75,6,8149.71,Stella Pinto,2,3,4,9,Regular
7083,24,4,4102.24,Emanuella Dias,3,2,2,7,Regular
7084,26,2,4097.59,Sofia Souza,3,1,2,6,Ocasional
7085,69,4,1886.8600000000001,Raul Moura,2,2,1,5,Ocasional
7086,78,3,2998.8,Enrico da Costa,2,1,2,5,Ocasional
7087,12,11,9567.68,Sra. Liz Peixoto,4,4,4,12,VIP
7088,47,2,1950.49,Luana Rezende,2,1,1,4,Ocasional
7089,23,3,3952.92,Ágatha Sá,3,1,2,6,Ocasional
7090,187,3,8935.199999999999,Olívia Aparecida,1,1,4,6,Ocasional
7091,50,4,1252.0900000000001,Ravi Lucca Garcia,2,2,1,5,Ocasional
7092,11,4,2407.2,Benjamim Fernandes,4,2,2,8,Regular
7093,80,4,2734.2400000000002,José Pedro Vieira,2,2,2,6,Ocasional
7094,78,1,242.44,Larissa Peixoto,2,1,1,4,Ocasional
7095,36,7,6992.59,Luna Monteiro,3,4,3,10,VIP
7096,11,3,1088.54,Henry Gabriel da Cunha,4,1,1,6,Ocasional
7097,76,5,5011.22,Isis Gomes,2,3,3,8,Regular
7098,14,5,13927.36,Leonardo Ramos,4,3,4,11,VIP
7099,20,2,2775.33,Maria Alice Pires,3,1,2,6,Ocasional
7100,24,4,2377.35,Clarice Caldeira,3,2,2,7,Regular
7101,53,8,8350.48,Kamilly da Mata,2,4,4,10,VIP
7102,32,5,10848.6,Maria Julia Peixoto,3,3,4,10,VIP
7103,70,3,8460.84,Srta. Maria Laura Sá,2,1,4,7,Regular
7104,212,2,2514.54,Natália Monteiro,1,1,2,4,Ocasional
7105,14,7,5887.75,João Andrade,4,4,3,11,VIP
7106,65,4,1645.3,Luan da Cruz,2,2,1,5,Ocasional
7107,1,4,11197.49,Esther Sampaio,4,2,4,10,VIP
7108,20,4,3679.12,Hellena Cardoso,3,2,2,7,Regular
7109,252,3,1059.4099999999999,Hellena Porto,1,1,1,3,Inativo
7110,6,7,15807.36,Dr. Samuel Aragão,4,4,4,12,VIP
7111,41,5,3651.09,Maria Vitória Rezende,3,3,2,8,Regular
7112,37,6,3758.69,Benicio Vargas,3,3,2,8,Regular
7113,42,7,9786.93,Yan Cavalcanti,3,4,4,11,VIP
7114,59,4,4176.49,Dr. Augusto Macedo,2,2,2,6,Ocasional
7115,213,2,203.95999999999998,João Lucas Cunha,1,1,1,3,Inativo
7116,29,8,11111.369999999999,Laís Rocha,3,4,4,11,VIP
7117,31,4,7450.45,Eduarda da Mata,3,2,4,9,Regular
7118,142,3,771.95,Sr. Lucas Nogueira,1,1,1,3,Inativo
7119,50,3,10416.73,Dr. Yan Vieira,2,1,4,7,Regular
7120,85,5,11752.5,Fernando Nascimento,2,3,4,9,Regular
7121,10,3,1022.2900000000001,Ana Luiza Porto,4,1,1,6,Ocasional
7122,39,7,13142.06,João Felipe Araújo,3,4,4,11,VIP
7123,14,7,4464.79,Heitor Gomes,4,4,3,11,VIP
7124,1,6,3960.6400000000003,Ana Beatriz Rocha,4,3,2,9,Regular
7125,83,3,1300.07,Igor Sales,2,1,1,4,Ocasional
7126,65,1,709.59,Lara Machado,2,1,1,4,Ocasional
7127,224,2,1415.9,Thomas Cavalcante,1,1,1,3,Inativo
7128,111,1,65.78,Luana Cirino,1,1,1,3,Inativo
7129,243,1,676.45,Ana Júlia Silveira,1,1,1,3,Inativo
7130,20,5,3611.4900000000002,Dr. Marcos Vinicius Barbosa,3,3,2,8,Regular
7131,66,5,7910.04,Maria Vitória Rocha,2,3,4,9,Regular
7132,54,4,5464.889999999999,Jade Oliveira,2,2,3,7,Regular
7133,48,5,8134.77,Dra. Ana Laura Cavalcanti,2,3,4,9,Regular
7134,40,11,15136.210000000001,Dra. Ísis Albuquerque,3,4,4,11,VIP
7135,34,6,6760.639999999999,Igor Duarte,3,3,3,9,Regular
7136,10,7,10916.37,Esther Moreira,4,4,4,12,VIP
7137,50,6,6387.5199999999995,José Ferreira,2,3,3,8,Regular
7138,82,3,7534.06,Lorenzo da Luz,2,1,4,7,Regular
7139,10,4,6994.639999999999,Pedro Henrique Cardoso,4,2,3,9,Regular
7141,28,6,9256.16,Melina Gonçalves,3,3,4,10,VIP
7142,35,7,8718.16,Dra. Letícia Martins,3,4,4,11,VIP
7143,89,1,135.2,Aurora Casa Grande,1,1,1,3,Inativo
7144,200,1,301.07,Luiz Felipe Garcia,1,1,1,3,Inativo
7145,65,4,3273.71,Stella Moura,2,2,2,6,Ocasional
7146,142,5,2638.19,Liam Ramos,1,3,2,6,Ocasional
7147,13,3,14232.009999999998,Sr. Raul Sales,4,1,4,9,Regular
7148,126,3,3346.19,Maria Luísa Monteiro,1,1,2,4,Ocasional
7149,53,8,6675.12,Gabriela Sales,2,4,3,9,Regular
7150,21,3,5118.2,Aylla da Costa,3,1,3,7,Regular
7152,7,3,2487.7,Emanuel Gonçalves,4,1,2,7,Regular
7153,312,3,5371.77,Rafaela Borges,1,1,3,5,Ocasional
7154,81,3,1631.65,Aurora Cassiano,2,1,1,4,Ocasional
7155,155,5,2600.04,Eloah Pereira,1,3,2,6,Ocasional
7156,41,5,2053.15,Ryan Cassiano,3,3,1,7,Regular
7157,211,2,1063.52,Rafaela Ferreira,1,1,1,3,Inativo
7158,59,4,2085.86,Amanda da Cruz,2,2,1,5,Ocasional
7159,21,7,11197.02,Pedro Miguel Rocha,3,4,4,11,VIP
7160,44,4,6146.23,Cauã da Rocha,2,2,3,7,Regular
7161,55,4,358.62,Stella Novais,2,2,1,5,Ocasional
7162,17,4,985.86,Dra. Ana Luiza da Costa,4,2,1,7,Regular
7163,120,5,8226.09,Maya Vasconcelos,1,3,4,8,Regular
7164,69,3,3734.7599999999998,Kamilly Santos,2,1,2,5,Ocasional
7165,63,4,3364.23,Bryan Pastor,2,2,2,6,Ocasional
7166,19,3,2086.55,Maria Isis Costela,4,1,1,6,Ocasional
7167,40,2,1910.6100000000001,Ana Novaes,3,1,1,5,Ocasional
7168,9,4,2704.8,Ana Julia Costela,4,2,2,8,Regular
7169,32,5,4475.33,Paulo Pacheco,3,3,3,9,Regular
7170,26,2,365.43,Nicole Carvalho,3,1,1,5,Ocasional
7171,100,4,2873.48,Arthur Gabriel Borges,1,2,2,5,Ocasional
7172,32,4,3982.2,Luiz Otávio Rocha,3,2,2,7,Regular
7173,46,5,8837.529999999999,Murilo Ferreira,2,3,4,9,Regular
7174,31,7,9228.68,Dr. Yuri Caldeira,3,4,4,11,VIP
7175,114,4,10192.349999999999,Rafaela Mendes,1,2,4,7,Regular
7176,11,5,9365.470000000001,Dra. Hadassa Nogueira,4,3,4,11,VIP
7177,115,4,2600.6,Otávio Pacheco,1,2,2,5,Ocasional
7178,116,4,4506.61,Fernanda Rios,1,2,3,6,Ocasional
7179,43,2,1284.19,Rodrigo Cirino,3,1,1,5,Ocasional
7180,71,2,1673.92,Dr. Bruno Mendonça,2,1,1,4,Ocasional
7181,32,7,13755.86,Yago Machado,3,4,4,11,VIP
7182,28,3,1727.88,Julia Costa,3,1,1,5,Ocasional
7183,65,5,10705.48,Kevin Costa,2,3,4,9,Regular
7184,331,1,2855.8,Ana Sophia da Costa,1,1,2,4,Ocasional
7185,44,6,15297.529999999999,Sra. Julia da Rosa,2,3,4,9,Regular
7186,2,4,3626.37,Sra. Alice Siqueira,4,2,2,8,Regular
7187,47,3,2956.7,Esther Siqueira,2,1,2,5,Ocasional
7188,128,5,9733.9,Ana Sophia Montenegro,1,3,4,8,Regular
7189,54,3,4563.65,Sra. Amanda Leão,2,1,3,6,Ocasional
7190,137,1,30.65,Miguel da Costa,1,1,1,3,Inativo
7191,31,4,5699.62,Eloá Ferreira,3,2,3,8,Regular
7192,39,7,16168.25,Pedro Lucas da Costa,3,4,4,11,VIP
7193,53,8,6782.86,Amanda Cardoso,2,4,3,9,Regular
7194,23,2,2001.19,Bernardo Abreu,3,1,1,5,Ocasional
7195,41,4,2845.74,Maria Leão,3,2,2,7,Regular
7196,34,2,7607.19,Ayla Teixeira,3,1,4,8,Regular
7197,31,5,2330.9300000000003,Lavínia da Rosa,3,3,2,8,Regular
7198,28,6,3042.65,Ian Teixeira,3,3,2,8,Regular
7199,122,3,1668.02,Arthur Sá,1,1,1,3,Inativo
7200,52,2,1363.26,Apollo Vargas,2,1,1,4,Ocasional
7201,128,5,3046.67,Hadassa Barros,1,3,2,6,Ocasional
7202,39,3,1351.02,João Felipe da Costa,3,1,1,5,Ocasional
7203,79,6,2333.12,Dr. Davi Lucca Mendonça,2,3,2,7,Regular
7204,51,6,9513.619999999999,Ester Duarte,2,3,4,9,Regular
7205,30,4,1831.3899999999999,Aurora da Conceição,3,2,1,6,Ocasional
7206,8,3,3446.1499999999996,Luana Azevedo,4,1,2,7,Regular
7207,9,7,11391.2,Luana Castro,4,4,4,12,VIP
7208,61,3,2563.17,Vitor Gabriel Sampaio,2,1,2,5,Ocasional
7209,2,3,1623.37,Bernardo Cassiano,4,1,1,6,Ocasional
7210,74,6,5612.099999999999,Sra. Ayla Freitas,2,3,3,8,Regular
7211,2,5,5128.75,Valentim Martins,4,3,3,10,VIP
7212,33,3,1738.63,Stella da Mota,3,1,1,5,Ocasional
7213,144,4,5066.68,Ágatha Sales,1,2,3,6,Ocasional
7214,223,5,5200.87,Clara Casa Grande,1,3,3,7,Regular
7215,19,4,1135.73,Milena Cardoso,4,2,1,7,Regular
7216,16,4,11192.12,Dra. Laís Marques,4,2,4,10,VIP
7217,1,7,20226.23,Sr. Murilo Araújo,4,4,4,12,VIP
7218,320,2,596.5,Lorena Abreu,1,1,1,3,Inativo
7219,75,4,10015.55,Ana Júlia Almeida,2,2,4,8,Regular
7220,5,7,20852.75,Gael Casa Grande,4,4,4,12,VIP
7221,3,7,6836.35,João Miguel Moura,4,4,3,11,VIP
7222,53,4,4342.9400000000005,Erick Casa Grande,2,2,2,6,Ocasional
7223,7,5,2990.18,Srta. Olívia Silva,4,3,2,9,Regular
7224,51,4,4345.0,Cecília Cunha,2,2,2,6,Ocasional
7225,24,6,2871.28,Maria Laura Câmara,3,3,2,8,Regular
7226,179,2,769.5899999999999,Bruno Vargas,1,1,1,3,Inativo
7227,200,4,9327.39,Fernanda Cunha,1,2,4,7,Regular
7228,32,7,5905.6,Hadassa Cavalcante,3,4,3,10,VIP
7229,40,6,12374.900000000001,Hellena Guerra,3,3,4,10,VIP
7230,35,2,2809.63,Zoe Cassiano,3,1,2,6,Ocasional
7231,16,5,7144.889999999999,Caio Ramos,4,3,3,10,VIP
7232,11,8,13039.2,João Pedro Ribeiro,4,4,4,12,VIP
7233,2,3,4368.59,Luigi Sousa,4,1,2,7,Regular
7234,72,4,2240.87,Vinicius Siqueira,2,2,1,5,Ocasional
7235,163,4,10507.34,José Sales,1,2,4,7,Regular
7236,28,3,2089.6800000000003,Larissa Cassiano,3,1,1,5,Ocasional
7237,56,5,9111.5,Ana Vitória da Mota,2,3,4,9,Regular
7238,2,4,881.01,Ana Clara da Costa,4,2,1,7,Regular
7239,34,5,12371.029999999999,Natália Pastor,3,3,4,10,VIP
7240,14,4,7388.99,Dr. Anthony Gabriel Pinto,4,2,4,10,VIP
7241,72,7,3283.35,Zoe da Paz,2,4,2,8,Regular
7243,40,7,9080.94,Srta. Maria Eduarda Jesus,3,4,4,11,VIP
7244,48,4,1797.74,Allana da Paz,2,2,1,5,Ocasional
7245,32,8,11961.619999999999,Raquel das Neves,3,4,4,11,VIP
7246,46,4,3810.42,Noah da Conceição,2,2,2,6,Ocasional
7247,33,3,611.22,Rebeca Souza,3,1,1,5,Ocasional
7248,156,6,5343.6,Alícia da Mota,1,3,3,7,Regular
7249,48,4,916.7900000000001,Renan Pastor,2,2,1,5,Ocasional
7250,67,4,2077.59,Maysa Aragão,2,2,1,5,Ocasional
7251,61,4,4947.8,Dr. Pedro Lucas Lima,2,2,3,7,Regular
7252,159,4,5206.88,Eduardo Novais,1,2,3,6,Ocasional
7253,222,2,5040.549999999999,Sr. Pedro Miguel das Neves,1,1,3,5,Ocasional
7254,3,5,7527.87,Srta. Marcela Fernandes,4,3,4,11,VIP
7255,70,2,1660.4,Beatriz Monteiro,2,1,1,4,Ocasional
7256,7,7,8935.939999999999,Srta. Ana Júlia Albuquerque,4,4,4,12,VIP
7257,148,2,1457.43,Camila da Cunha,1,1,1,3,Inativo
7258,14,8,5931.34,Ana Liz Mendes,4,4,3,11,VIP
7259,38,4,4657.14,Cauê Camargo,3,2,3,8,Regular
7260,39,11,10550.550000000001,Lara Martins,3,4,4,11,VIP
7261,201,1,815.39,Brenda Albuquerque,1,1,1,3,Inativo
7262,53,2,1445.9299999999998,Yuri Pires,2,1,1,4,Ocasional
7263,10,6,4007.12,Catarina Martins,4,3,2,9,Regular
7264,16,2,2777.96,Zoe Macedo,4,1,2,7,Regular
7265,70,3,931.95,Sra. Ísis Viana,2,1,1,4,Ocasional
7266,182,3,2352.0,Asafe Gonçalves,1,1,2,4,Ocasional
7267,11,4,4535.17,Maria Macedo,4,2,3,9,Regular
7268,6,4,1725.83,Sabrina Fogaça,4,2,1,7,Regular
7269,107,4,4693.9800000000005,Gustavo Novais,1,2,3,6,Ocasional
7271,95,3,7762.860000000001,Dr. Miguel Azevedo,1,1,4,6,Ocasional
7272,1,7,13726.82,Fernanda Cirino,4,4,4,12,VIP
7273,48,4,1185.73,Luiz Otávio Cassiano,2,2,1,5,Ocasional
7274,32,9,7783.26,Sr. José Pedro Sousa,3,4,4,11,VIP
7275,3,5,5888.3,Dra. Sophia Siqueira,4,3,3,10,VIP
7276,20,7,11272.77,Emilly Dias,3,4,4,11,VIP
7278,118,5,7100.33,Asafe Santos,1,3,3,7,Regular
7279,74,6,8184.11,Maria Martins,2,3,4,9,Regular
7280,40,3,2901.66,João Lucas Sá,3,1,2,6,Ocasional
7281,81,3,1975.5300000000002,Dr. Gustavo Henrique Peixoto,2,1,1,4,Ocasional
7282,90,2,1361.37,Matteo Castro,1,1,1,3,Inativo
7283,49,7,13067.02,Luiza Jesus,2,4,4,10,VIP
7284,104,4,4682.78,Sarah Peixoto,1,2,3,6,Ocasional
7285,35,8,7014.820000000001,Emilly Melo,3,4,3,10,VIP
7286,39,3,6134.04,Sabrina Nascimento,3,1,3,7,Regular
7287,16,4,3061.6499999999996,Alícia Araújo,4,2,2,8,Regular
7288,105,1,670.86,Daniel Cunha,1,1,1,3,Inativo
7289,249,2,3901.29,Manuella da Rosa,1,1,2,4,Ocasional
7290,5,3,6402.4,Calebe Leão,4,1,3,8,Regular
7291,47,2,3957.8,Heloísa Costa,2,1,2,5,Ocasional
7292,63,3,205.67,Bernardo Siqueira,2,1,1,4,Ocasional
7293,5,7,11996.439999999999,Erick Cavalcante,4,4,4,12,VIP
7294,39,6,6012.13,Pedro Lucas Mendes,3,3,3,9,Regular
7295,5,4,7847.68,Emilly Carvalho,4,2,4,10,VIP
7296,9,8,6888.81,Ana Carolina Peixoto,4,4,3,11,VIP
7297,98,3,2075.16,Ravi Silveira,1,1,1,3,Inativo
7298,96,4,1513.56,Josué Barbosa,1,2,1,4,Ocasional
7299,4,5,4148.17,Dra. Zoe Machado,4,3,2,9,Regular
7300,302,3,2813.86,Maria Sophia Barros,1,1,2,4,Ocasional
7301,261,2,252.39999999999998,Stephany Duarte,1,1,1,3,Inativo
7302,40,5,779.48,Isaque Nunes,3,3,1,7,Regular
7303,124,4,4581.04,Amanda Jesus,1,2,3,6,Ocasional
7304,34,6,9523.88,Maria Laura Araújo,3,3,4,10,VIP
7305,34,4,10434.6,Srta. Alícia Casa Grande,3,2,4,9,Regular
7306,8,7,8292.0,Larissa Fernandes,4,4,4,12,VIP
7307,10,10,9099.57,Sr. Henry Gabriel Casa Grande,4,4,4,12,VIP
7308,2,6,16568.64,Maria Sophia Cavalcanti,4,3,4,11,VIP
7309,20,5,12033.240000000002,Joaquim Aragão,3,3,4,10,VIP
7310,3,4,4085.72,Lavínia Ramos,4,2,2,8,Regular
7311,80,3,3936.83,Brayan Fogaça,2,1,2,5,Ocasional
7312,79,5,9171.779999999999,Luiz Henrique Teixeira,2,3,4,9,Regular
7313,75,2,4114.469999999999,Lorenzo da Luz,2,1,2,5,Ocasional
7314,192,1,1199.22,Kaique Araújo,1,1,1,3,Inativo
7315,91,2,3460.8399999999997,Pedro Lucas da Mata,1,1,2,4,Ocasional
7316,8,3,2580.9500000000003,Marcelo Freitas,4,1,2,7,Regular
7317,261,3,452.12,Eduarda Pires,1,1,1,3,Inativo
7318,54,3,1946.2,Aylla Dias,2,1,1,4,Ocasional
7319,110,3,2760.76,Leandro Carvalho,1,1,2,4,Ocasional
7320,229,5,3723.04,Ravy Souza,1,3,2,6,Ocasional
7321,81,3,2392.58,Felipe da Cruz,2,1,2,5,Ocasional
7322,114,4,2248.2200000000003,Ryan Pastor,1,2,1,4,Ocasional
7323,60,2,2302.59,Liz Jesus,2,1,2,5,Ocasional
7324,58,7,11880.060000000001,Benjamim Rezende,2,4,4,10,VIP
7325,3,4,3605.75,Srta. Maria Alice Sampaio,4,2,2,8,Regular
7326,20,3,4779.4,Maria Sophia Mendonça,3,1,3,7,Regular
7327,257,1,4582.4,Calebe Santos,1,1,3,5,Ocasional
7328,18,5,7195.900000000001,Maysa Pacheco,4,3,3,10,VIP
7329,99,4,4197.3,Dr. Brayan Farias,1,2,2,5,Ocasional
7330,76,4,4166.58,Yan Azevedo,2,2,2,6,Ocasional
7331,7,7,12464.91,Srta. Anna Liz Oliveira,4,4,4,12,VIP
7332,47,4,5777.57,Stella Farias,2,2,3,7,Regular
7333,119,4,10071.67,Dra. Larissa Siqueira,1,2,4,7,Regular
7334,50,1,273.52,Lívia Peixoto,2,1,1,4,Ocasional
7335,24,3,2197.2000000000003,Thiago Albuquerque,3,1,1,5,Ocasional
7336,11,4,1845.2299999999998,Luan Cavalcante,4,2,1,7,Regular
7337,33,3,416.18,Antonella Costa,3,1,1,5,Ocasional
7338,259,3,2750.36,Sra. Maria Alice Lopes,1,1,2,4,Ocasional
7339,27,3,1066.97,Otávio Dias,3,1,1,5,Ocasional
7340,11,3,2518.7599999999998,Gael Machado,4,1,2,7,Regular
7341,18,6,5214.38,Antonella Rocha,4,3,3,10,VIP
7342,22,3,2953.83,Luiz Felipe Sampaio,3,1,2,6,Ocasional
7343,47,3,611.32,Sr. Caio Sampaio,2,1,1,4,Ocasional
7344,23,5,4991.89,Pedro Miguel Campos,3,3,3,9,Regular
7345,295,1,82.66,Juliana Moreira,1,1,1,3,Inativo
7346,40,5,3083.19,Sr. Rhavi Lopes,3,3,2,8,Regular
7347,23,3,1442.88,Ana Luiza Mendonça,3,1,1,5,Ocasional
7348,52,7,10579.09,Ana Julia Ramos,2,4,4,10,VIP
7349,80,1,685.23,Cauê Brito,2,1,1,4,Ocasional
7350,35,7,2705.7,Heloísa Melo,3,4,2,9,Regular
7351,41,3,5254.32,Davi Lucas Aparecida,3,1,3,7,Regular
7352,113,4,3924.5,Davi Lima,1,2,2,5,Ocasional
7353,1,3,3459.89,Sabrina Lopes,4,1,2,7,Regular
7354,17,4,6852.41,Dr. Leonardo da Mata,4,2,3,9,Regular
7355,33,1,2847.15,Sr. Theodoro Lima,3,1,2,6,Ocasional
7356,54,6,6615.08,Isabela Caldeira,2,3,3,8,Regular
7357,14,3,5765.95,Fernando Borges,4,1,3,8,Regular
7358,8,9,9825.75,Matteo Cunha,4,4,4,12,VIP
7359,27,2,917.53,Maria Flor Montenegro,3,1,1,5,Ocasional
7361,7,3,2418.11,Emilly Melo,4,1,2,7,Regular
7362,1,7,11871.83,Jade Albuquerque,4,4,4,12,VIP
7363,117,4,6029.35,Bruna Cavalcante,1,2,3,6,Ocasional
7364,219,4,2665.13,Srta. Ana Beatriz Alves,1,2,2,5,Ocasional
7365,10,5,1939.83,Ravy Vasconcelos,4,3,1,8,Regular
7366,36,3,3419.23,Isaque Dias,3,1,2,6,Ocasional
7367,45,3,4387.12,Ana Liz Machado,2,1,3,6,Ocasional
7368,2,6,13313.119999999999,Gael Vieira,4,3,4,11,VIP
7369,51,4,4250.49,Alana da Rocha,2,2,2,6,Ocasional
7370,34,9,11292.68,Giovanna Costa,3,4,4,11,VIP
7371,4,9,7621.18,Thiago da Mata,4,4,4,12,VIP
7372,47,3,1315.72,Daniela Moraes,2,1,1,4,Ocasional
7373,13,6,4240.34,João Miguel Vieira,4,3,2,9,Regular
7374,6,5,1421.2,Pedro Camargo,4,3,1,8,Regular
7375,40,2,969.79,Arthur Gabriel Sales,3,1,1,5,Ocasional
7376,107,5,6056.28,Lunna da Cunha,1,3,3,7,Regular
7377,39,3,2169.2,Luana Viana,3,1,1,5,Ocasional
7378,79,4,6680.79,Zoe da Cunha,2,2,3,7,Regular
7379,100,4,3224.55,Ana Júlia Sales,1,2,2,5,Ocasional
7380,15,7,10550.439999999999,Vicente Viana,4,4,4,12,VIP
7381,37,13,21137.05,Mateus Silva,3,4,4,11,VIP
7382,43,3,5536.09,Eloah Gonçalves,3,1,3,7,Regular
7383,158,3,4877.55,Thiago Ribeiro,1,1,3,5,Ocasional
7384,12,3,2369.71,Natália Santos,4,1,2,7,Regular
7385,42,5,4879.63,Clarice Dias,3,3,3,9,Regular
7386,54,4,4325.97,André Cardoso,2,2,2,6,Ocasional
7387,7,4,2791.87,Theo Rios,4,2,2,8,Regular
7388,241,2,2287.06,Davi Cassiano,1,1,2,4,Ocasional
7389,43,4,2150.63,Maria Vitória Moraes,3,2,1,6,Ocasional
7390,4,6,10828.720000000001,João Garcia,4,3,4,11,VIP
7391,101,2,441.89,Sarah da Mota,1,1,1,3,Inativo
7392,14,3,3003.52,Erick Duarte,4,1,2,7,Regular
7393,28,7,4499.92,Ana Júlia Porto,3,4,3,10,VIP
7394,24,4,4532.28,Dr. João Gabriel Cavalcanti,3,2,3,8,Regular
7395,106,1,901.67,Ana Júlia Araújo,1,1,1,3,Inativo
7396,48,7,17404.25,Murilo Brito,2,4,4,10,VIP
7397,26,6,8248.869999999999,Isaque da Rosa,3,3,4,10,VIP
7398,215,1,1234.49,Bento Carvalho,1,1,1,3,Inativo
7399,46,4,2591.7,Dr. Leandro Costela,2,2,2,6,Ocasional
7400,32,2,6650.58,Laura Abreu,3,1,3,7,Regular
7401,225,4,14425.42,Heloisa Leão,1,2,4,7,Regular
7402,2,5,17869.6,Guilherme Andrade,4,3,4,11,VIP
7403,8,2,1094.14,Bruna Montenegro,4,1,1,6,Ocasional
7404,33,6,3482.6,Maria Vitória Sousa,3,3,2,8,Regular
7405,7,7,6278.02,Josué Câmara,4,4,3,11,VIP
7406,61,2,742.44,Kevin Viana,2,1,1,4,Ocasional
7407,119,4,7259.539999999999,Dr. Brayan da Conceição,1,2,3,6,Ocasional
7408,9,3,1337.98,Natália Nogueira,4,1,1,6,Ocasional
7409,5,4,4068.49,Heloisa Pimenta,4,2,2,8,Regular
7410,86,5,4284.98,Ester Alves,2,3,2,7,Regular
7411,142,2,738.55,Dante da Luz,1,1,1,3,Inativo
7412,57,3,2991.31,Srta. Isabelly Barbosa,2,1,2,5,Ocasional
7413,33,11,15709.55,Dra. Catarina Souza,3,4,4,11,VIP
7414,136,6,6707.24,Lívia Sampaio,1,3,3,7,Regular
7415,27,5,2405.63,Asafe Sousa,3,3,2,8,Regular
7416,81,6,5053.25,Vinícius Novais,2,3,3,8,Regular
7417,173,4,3334.2999999999997,Théo Casa Grande,1,2,2,5,Ocasional
7418,238,3,3320.56,João Pedro Azevedo,1,1,2,4,Ocasional
7419,48,3,2083.7,Léo Monteiro,2,1,1,4,Ocasional
7420,36,4,8236.5,Francisco Peixoto,3,2,4,9,Regular
7421,106,3,2784.81,Daniela Vasconcelos,1,1,2,4,Ocasional
7422,168,3,884.17,Paulo Cavalcante,1,1,1,3,Inativo
7423,4,8,7879.46,Pedro Miguel Rocha,4,4,4,12,VIP
7424,39,5,11789.2,Igor Gonçalves,3,3,4,10,VIP
7425,32,9,6621.05,Laura Albuquerque,3,4,3,10,VIP
7426,306,1,773.89,Samuel Casa Grande,1,1,1,3,Inativo
7427,66,3,6839.150000000001,Gustavo Porto,2,1,3,6,Ocasional
7428,18,5,2480.76,André Alves,4,3,2,9,Regular
7429,40,2,170.8,Isaac Aragão,3,1,1,5,Ocasional
7430,59,1,856.75,Kaique Freitas,2,1,1,4,Ocasional
7431,56,6,3123.18,Ana Júlia Souza,2,3,2,7,Regular
7432,111,4,5761.02,Aylla Mendonça,1,2,3,6,Ocasional
7433,26,4,5653.11,Davi Lucas Nascimento,3,2,3,8,Regular
7434,55,3,3479.73,Sophie Casa Grande,2,1,2,5,Ocasional
7435,12,6,15285.87,Lucas Lopes,4,3,4,11,VIP
7436,214,2,5122.88,Maria Flor da Rosa,1,1,3,5,Ocasional
7437,10,7,9511.9,Dra. Marina Nunes,4,4,4,12,VIP
7438,14,5,2650.8,Dr. Gabriel Fonseca,4,3,2,9,Regular
7439,26,2,1792.17,Maria Luiza Andrade,3,1,1,5,Ocasional
7440,18,7,9000.44,Apollo Andrade,4,4,4,12,VIP
7441,10,7,15474.17,Dr. Isaac Mendes,4,4,4,12,VIP
7442,18,2,3811.8599999999997,Sabrina Ramos,4,1,2,7,Regular
7443,111,5,6374.77,Dom Ribeiro,1,3,3,7,Regular
7444,12,7,6941.530000000001,Dr. Ian Castro,4,4,3,11,VIP
7445,97,2,1051.8,Dr. Diego Gonçalves,1,1,1,3,Inativo
7446,49,3,1362.02,Yuri Correia,2,1,1,4,Ocasional
7447,28,2,1037.86,Cecília Macedo,3,1,1,5,Ocasional
7448,117,2,903.74,João Vitor Mendes,1,1,1,3,Inativo
7449,106,5,5538.110000000001,Srta. Daniela Campos,1,3,3,7,Regular
7450,40,4,2658.2799999999997,Danilo Lopes,3,2,2,7,Regular
7451,192,3,1273.29,Dr. Paulo Rocha,1,1,1,3,Inativo
7452,24,3,5983.61,Sr. Caio Oliveira,3,1,3,7,Regular
7453,6,5,4672.75,Amanda Novaes,4,3,3,10,VIP
7454,10,5,3620.76,Dr. Luiz Miguel Costa,4,3,2,9,Regular
7455,125,5,3695.8399999999997,Sra. Cecilia Abreu,1,3,2,6,Ocasional
7456,36,4,7410.170000000001,Pietro Borges,3,2,4,9,Regular
7457,68,2,2364.52,Henry Gabriel Carvalho,2,1,2,5,Ocasional
7458,134,3,6368.35,Thales Silveira,1,1,3,5,Ocasional
7459,6,5,5059.650000000001,Luana Brito,4,3,3,10,VIP
7460,4,3,7431.58,Ester Cavalcante,4,1,4,9,Regular
7461,15,4,2029.3500000000001,Dra. Ana Julia Peixoto,4,2,1,7,Regular
7462,16,6,11015.67,Luiz Gustavo Pires,4,3,4,11,VIP
7463,87,4,2045.16,Sr. Luigi Oliveira,2,2,1,5,Ocasional
7464,161,3,850.3100000000001,Heloísa Rezende,1,1,1,3,Inativo
7465,115,4,1669.94,Sr. Vitor Albuquerque,1,2,1,4,Ocasional
7466,88,5,9354.99,Hadassa Rocha,1,3,4,8,Regular
7467,11,3,2851.53,Marina Costa,4,1,2,7,Regular
7468,65,5,4490.68,Dra. Evelyn Aragão,2,3,3,8,Regular
7469,339,1,76.79,Leandro Casa Grande,1,1,1,3,Inativo
7470,131,4,2389.19,Marcos Vinicius Gonçalves,1,2,2,5,Ocasional
7471,100,1,286.06,Isaque Lopes,1,1,1,3,Inativo
7472,121,3,3021.23,Brayan Jesus,1,1,2,4,Ocasional
7473,47,3,2916.0299999999997,Giovanna das Neves,2,1,2,5,Ocasional
7474,32,4,6790.530000000001,Helena Moreira,3,2,3,8,Regular
7475,66,6,10810.06,Yago Lima,2,3,4,9,Regular
7476,58,7,8004.85,Josué Albuquerque,2,4,4,10,VIP
7477,66,7,11638.78,Luna da Cunha,2,4,4,10,VIP
7478,60,6,6797.200000000001,Yan Castro,2,3,3,8,Regular
7479,300,3,922.75,Erick Cirino,1,1,1,3,Inativo
7480,8,6,2975.98,Vinícius da Cruz,4,3,2,9,Regular
7481,142,5,2896.56,Sara da Mota,1,3,2,6,Ocasional
7482,7,2,770.1099999999999,Alícia Costela,4,1,1,6,Ocasional
7483,5,6,5168.23,Heitor Pires,4,3,3,10,VIP
7484,33,7,7847.6,Lorenzo Moraes,3,4,4,11,VIP
7485,195,3,1897.35,Gabriela Dias,1,1,1,3,Inativo
7486,170,1,229.09,Isabela Martins,1,1,1,3,Inativo
7487,30,7,17298.94,Sr. Gael Cavalcante,3,4,4,11,VIP
7488,10,4,6571.34,Joaquim Cunha,4,2,3,9,Regular
7489,1,5,11626.84,Ísis Abreu,4,3,4,11,VIP
7490,6,4,6768.14,Maria Flor Moraes,4,2,3,9,Regular
7491,90,5,9582.52,Calebe Caldeira,1,3,4,8,Regular
7492,87,3,1343.73,Dra. Luna Fernandes,2,1,1,4,Ocasional
7494,258,1,56.52,Eduardo Fogaça,1,1,1,3,Inativo
7495,204,1,660.25,Luiz Felipe Andrade,1,1,1,3,Inativo
7496,12,7,3445.11,Vinícius Caldeira,4,4,2,10,VIP
7497,4,5,10794.05,Cecília Guerra,4,3,4,11,VIP
7498,38,3,3188.85,João Vitor Monteiro,3,1,2,6,Ocasional
7499,1,5,4654.28,Dom Aragão,4,3,3,10,VIP
7500,6,12,11597.42,Pedro Henrique Melo,4,4,4,12,VIP
7501,25,6,8724.5,Nina Guerra,3,3,4,10,VIP
7502,201,5,4773.05,Srta. Bella Rodrigues,1,3,3,7,Regular
7503,58,4,2906.4,Sr. Lucas Gabriel Cavalcanti,2,2,2,6,Ocasional
7504,109,2,3010.58,Gabriela Ribeiro,1,1,2,4,Ocasional
7505,13,3,274.67,Henrique Barbosa,4,1,1,6,Ocasional
7506,37,9,9602.11,Renan Rios,3,4,4,11,VIP
7507,227,1,278.57,Sr. Heitor da Mota,1,1,1,3,Inativo
7508,21,3,975.1,Luna Aragão,3,1,1,5,Ocasional
7509,118,2,1154.28,Raul das Neves,1,1,1,3,Inativo
7510,158,4,4471.3,Nicolas Abreu,1,2,3,6,Ocasional
7511,9,7,12087.8,Igor Mendes,4,4,4,12,VIP
7512,44,7,10925.54,Dr. José Cassiano,2,4,4,10,VIP
7513,47,5,7552.86,Theo Sales,2,3,4,9,Regular
7514,135,3,7600.47,Vinicius Nunes,1,1,4,6,Ocasional
7515,307,1,880.97,Anthony Gabriel da Cunha,1,1,1,3,Inativo
7516,52,2,2106.95,Olivia Andrade,2,1,1,4,Ocasional
7517,239,1,483.9,Sr. Antony Andrade,1,1,1,3,Inativo
7518,9,5,5265.57,Daniela Sousa,4,3,3,10,VIP
7519,40,5,5793.96,Isaque Vieira,3,3,3,9,Regular
7520,59,5,6119.15,Cauê Cavalcanti,2,3,3,8,Regular
7521,4,7,10359.34,Maria Isis Barbosa,4,4,4,12,VIP
7522,3,2,8389.560000000001,Ana Castro,4,1,4,9,Regular
7523,75,5,4084.7700000000004,Sr. Vitor Gabriel da Paz,2,3,2,7,Regular
7524,47,4,6014.129999999999,Ana Luiza Pereira,2,2,3,7,Regular
7525,10,3,3777.99,Kevin Caldeira,4,1,2,7,Regular
7526,25,2,2000.88,Manuella Azevedo,3,1,1,5,Ocasional
7527,21,6,4531.8,Dra. Luna da Rosa,3,3,3,9,Regular
7528,202,5,4445.16,Thomas Gomes,1,3,3,7,Regular
7529,12,5,4772.5,Bárbara Mendes,4,3,3,10,VIP
7530,8,6,8024.66,Luiz Miguel Fonseca,4,3,4,11,VIP
7531,34,5,3229.81,Alice Pimenta,3,3,2,8,Regular
7532,47,9,9717.27,Ana Cecília Albuquerque,2,4,4,10,VIP
7533,14,7,13311.08,Isadora das Neves,4,4,4,12,VIP
7534,166,1,656.87,Vitor Martins,1,1,1,3,Inativo
7535,101,2,5755.38,Sarah Sousa,1,1,3,5,Ocasional
7536,210,4,4455.03,Ravy da Rocha,1,2,3,6,Ocasional
7537,49,4,1950.04,Davi Lucca Caldeira,2,2,1,5,Ocasional
7538,41,2,1501.48,Srta. Ana Lívia Pastor,3,1,1,5,Ocasional
7539,242,2,5254.280000000001,Josué Fernandes,1,1,3,5,Ocasional
7540,16,7,10083.41,Dr. Davi Miguel Pastor,4,4,4,12,VIP
7541,21,6,16794.08,Brayan Nascimento,3,3,4,10,VIP
7542,75,5,3255.63,Dr. Guilherme da Paz,2,3,2,7,Regular
7543,153,4,4533.08,Benjamin Nogueira,1,2,3,6,Ocasional
7544,151,4,12230.62,Diogo Costa,1,2,4,7,Regular
7545,46,4,2185.6800000000003,Diego Barros,2,2,1,5,Ocasional
7546,9,3,2376.9300000000003,Isabel Santos,4,1,2,7,Regular
7547,9,7,11246.66,Ana Cecília Macedo,4,4,4,12,VIP
7548,39,5,10601.05,Clarice Campos,3,3,4,10,VIP
7549,87,2,4077.29,Samuel Moura,2,1,2,5,Ocasional
7550,14,4,3690.2500000000005,Sr. Bernardo Nascimento,4,2,2,8,Regular
7551,45,1,2583.97,Dra. Alice Rezende,2,1,2,5,Ocasional
7552,8,6,11875.25,Antônio Rodrigues,4,3,4,11,VIP
7553,88,5,8107.36,Thiago Cardoso,1,3,4,8,Regular
7554,35,6,4149.79,Manuella Aparecida,3,3,2,8,Regular
7555,20,3,1891.51,Isabelly Sousa,3,1,1,5,Ocasional
7556,73,4,2999.6800000000003,Pedro Miguel Araújo,2,2,2,6,Ocasional
7557,19,2,5054.8,Raul Barbosa,4,1,3,8,Regular
7558,39,4,6056.82,Maria Luiza Macedo,3,2,3,8,Regular
7559,47,2,1429.86,Fernando Macedo,2,1,1,4,Ocasional
7560,2,6,8251.09,Sophie Ribeiro,4,3,4,11,VIP
7561,5,7,12327.21,Benjamin Araújo,4,4,4,12,VIP
7562,38,5,7212.52,Luana Silveira,3,3,3,9,Regular
7563,11,3,6269.379999999999,Dra. Pietra Vasconcelos,4,1,3,8,Regular
7564,57,6,4981.46,Pedro Miguel Pereira,2,3,3,8,Regular
7565,5,5,5244.25,José Pedro Moreira,4,3,3,10,VIP
7566,21,2,4824.3099999999995,Sr. Luan Aragão,3,1,3,7,Regular
7567,100,6,3471.1499999999996,Srta. Zoe Moura,1,3,2,6,Ocasional
7568,180,3,3508.18,Josué Costela,1,1,2,4,Ocasional
7569,13,4,19361.72,Sra. Lavínia Santos,4,2,4,10,VIP
7570,27,4,1575.23,Lucas Silveira,3,2,1,6,Ocasional
7571,86,5,14303.6,Nathan Pires,2,3,4,9,Regular
7572,42,7,6692.1900000000005,Ravi Cunha,3,4,3,10,VIP
7573,47,4,3542.16,Laura Barbosa,2,2,2,6,Ocasional
7574,4,5,4805.9,Fernanda Vieira,4,3,3,10,VIP
7575,26,3,1988.62,Sra. Aurora da Conceição,3,1,1,5,Ocasional
7576,44,5,7734.4,Erick Ramos,2,3,4,9,Regular
7577,18,8,6259.6,Luiz Otávio Macedo,4,4,3,11,VIP
7578,34,7,4434.67,Luara Andrade,3,4,3,10,VIP
7579,4,5,3562.69,Joaquim Costela,4,3,2,9,Regular
7580,51,5,1198.57,Danilo Santos,2,3,1,6,Ocasional
7581,55,2,1965.25,Davi Miguel Barros,2,1,1,4,Ocasional
7582,202,5,4555.99,Vitor Hugo Nunes,1,3,3,7,Regular
7583,153,3,2003.8899999999999,Sra. Ana Laura Alves,1,1,1,3,Inativo
7584,53,5,6216.29,Rodrigo Sousa,2,3,3,8,Regular
7585,71,7,9414.0,Julia Ribeiro,2,4,4,10,VIP
7586,96,3,6301.88,Laura Barros,1,1,3,5,Ocasional
7587,19,9,5201.41,Marcela Aragão,4,4,3,11,VIP
7588,36,3,2229.87,Lívia Câmara,3,1,1,5,Ocasional
7589,15,4,4436.45,Ana Luiza Novais,4,2,3,9,Regular
7590,29,6,5765.110000000001,Maria Borges,3,3,3,9,Regular
7591,120,5,3951.88,Vitória Freitas,1,3,2,6,Ocasional
7592,8,5,6022.570000000001,Evelyn Casa Grande,4,3,3,10,VIP
7593,241,1,31.92,Clara Freitas,1,1,1,3,Inativo
7594,94,5,3709.52,Maysa Silva,1,3,2,6,Ocasional
7595,140,5,1744.92,Antônio Cardoso,1,3,1,5,Ocasional
7596,24,4,3202.94,Otto Farias,3,2,2,7,Regular
7597,96,2,1432.27,Eduarda Dias,1,1,1,3,Inativo
7598,170,3,947.24,Lavínia Moreira,1,1,1,3,Inativo
7599,29,3,1062.45,Caio Sales,3,1,1,5,Ocasional
7600,97,6,15255.91,Maria Eduarda Freitas,1,3,4,8,Regular
7601,78,2,3974.55,Vicente Fonseca,2,1,2,5,Ocasional
7602,2,3,4036.14,Nicolas Viana,4,1,2,7,Regular
7603,26,7,10854.09,Maya Melo,3,4,4,11,VIP
7604,41,4,2806.11,Nicole Montenegro,3,2,2,7,Regular
7605,38,1,1603.36,Elisa Duarte,3,1,1,5,Ocasional
7606,31,5,7389.929999999999,Maria Clara Melo,3,3,4,10,VIP
7607,111,5,6330.98,Cecilia Fonseca,1,3,3,7,Regular
7608,10,3,8017.889999999999,Sr. Benício da Mata,4,1,4,9,Regular
7609,6,7,5852.8,Cauê Ramos,4,4,3,11,VIP
7610,10,5,6686.94,Theodoro Novais,4,3,3,10,VIP
7611,14,3,2867.3900000000003,Théo Ribeiro,4,1,2,7,Regular
7612,49,3,6357.16,Beatriz Vasconcelos,2,1,3,6,Ocasional
7613,84,5,4282.320000000001,Mirella Sampaio,2,3,2,7,Regular
7614,67,6,3992.41,Maria Clara Aparecida,2,3,2,7,Regular
7615,127,5,4795.5599999999995,Ana Carolina Correia,1,3,3,7,Regular
7616,34,5,1598.6799999999998,Vinicius Guerra,3,3,1,7,Regular
7617,19,5,1578.29,Jade Novaes,4,3,1,8,Regular
7618,50,5,6473.570000000001,Olivia Alves,2,3,3,8,Regular
7619,23,3,1483.62,Ana Laura Lopes,3,1,1,5,Ocasional
7620,87,5,8388.25,Maysa Leão,2,3,4,9,Regular
7621,20,2,2812.3199999999997,Ana Liz Nascimento,3,1,2,6,Ocasional
7622,9,5,5750.87,Bento Campos,4,3,3,10,VIP
7623,9,4,1729.58,Ana Júlia das Neves,4,2,1,7,Regular
7624,12,8,9077.82,Sr. João Vasconcelos,4,4,4,12,VIP
7625,57,5,4790.16,Enzo Azevedo,2,3,3,8,Regular
7626,86,4,8997.82,Josué Fernandes,2,2,4,8,Regular
7627,53,3,2614.71,Ravy Aparecida,2,1,2,5,Ocasional
7628,65,5,5883.53,Clarice Camargo,2,3,3,8,Regular
7629,34,9,15983.16,Heloisa Leão,3,4,4,11,VIP
7630,20,4,2802.2,Ana Luiza Vargas,3,2,2,7,Regular
7631,36,3,2586.91,Alice Albuquerque,3,1,2,6,Ocasional
7632,291,1,872.21,Cauã Porto,1,1,1,3,Inativo
7633,20,4,1251.21,Stella Costela,3,2,1,6,Ocasional
7634,16,2,1123.29,Maria Eduarda Oliveira,4,1,1,6,Ocasional
7635,108,4,2640.2999999999997,Letícia Cassiano,1,2,2,5,Ocasional
7636,36,5,7701.83,Liam Novais,3,3,4,10,VIP
7637,3,4,5054.3,Dra. Mariane Correia,4,2,3,9,Regular
7638,129,2,571.48,Vitor Hugo Montenegro,1,1,1,3,Inativo
7639,2,7,7732.86,Arthur Gabriel Cavalcanti,4,4,4,12,VIP
7640,232,2,801.05,Ryan Albuquerque,1,1,1,3,Inativo
7641,25,4,4254.19,Isaque Ramos,3,2,2,7,Regular
7642,59,4,6665.91,Luna Mendonça,2,2,3,7,Regular
7643,4,3,394.40999999999997,Dr. Marcos Vinicius Moura,4,1,1,6,Ocasional
7644,96,6,6095.74,Eduarda Pacheco,1,3,3,7,Regular
7645,35,5,6739.05,Eloá Câmara,3,3,3,9,Regular
7646,61,7,14533.59,Laura Ramos,2,4,4,10,VIP
7647,128,4,8129.83,Maria Luísa Nogueira,1,2,4,7,Regular
7648,19,2,539.93,Juan Martins,4,1,1,6,Ocasional
7649,14,7,3871.14,Alexandre Aragão,4,4,2,10,VIP
7650,73,3,5802.03,Maria Júlia Câmara,2,1,3,6,Ocasional
7651,72,7,8285.65,Otávio Sá,2,4,4,10,VIP
7652,26,4,1278.76,Ester Montenegro,3,2,1,6,Ocasional
7653,88,3,1866.0500000000002,Ana Barros,1,1,1,3,Inativo
7654,7,6,12612.150000000001,Vitor Hugo da Cruz,4,3,4,11,VIP
7655,209,1,883.9,José Nogueira,1,1,1,3,Inativo
7656,41,6,6564.7,Davi Lucca Alves,3,3,3,9,Regular
7657,50,8,7892.41,Henrique Farias,2,4,4,10,VIP
7658,109,9,11401.17,Davi Miguel Aragão,1,4,4,9,Regular
7659,23,3,3384.62,João Miguel Ferreira,3,1,2,6,Ocasional
7660,97,3,2984.6800000000003,Emanuella Fernandes,1,1,2,4,Ocasional
7661,148,5,10554.73,Catarina Santos,1,3,4,8,Regular
7662,15,5,7898.14,Aurora Cunha,4,3,4,11,VIP
7663,161,5,2819.35,Sr. Enrico Casa Grande,1,3,2,6,Ocasional
7664,30,2,839.12,Alana Machado,3,1,1,5,Ocasional
7665,20,4,3016.91,Thales Mendonça,3,2,2,7,Regular
7667,31,6,8121.84,Breno Brito,3,3,4,10,VIP
7668,118,2,237.28,Miguel Guerra,1,1,1,3,Inativo
7669,126,3,8495.880000000001,Ana Luiza Nunes,1,1,4,6,Ocasional
7670,15,6,11508.67,Vitor Gabriel Fonseca,4,3,4,11,VIP
7671,42,7,10927.14,Laís Lima,3,4,4,11,VIP
7672,43,2,3344.58,Alícia Rezende,3,1,2,6,Ocasional
7673,77,4,4009.2,Dra. Lavínia Vasconcelos,2,2,2,6,Ocasional
7674,42,3,3111.51,Gustavo Henrique Teixeira,3,1,2,6,Ocasional
7675,5,6,8564.65,Melissa Lopes,4,3,4,11,VIP
7676,69,5,6225.79,Dra. Ana Vitória Novaes,2,3,3,8,Regular
7677,23,3,1350.1699999999998,Zoe Cavalcante,3,1,1,5,Ocasional
7678,21,3,1305.46,Isabelly da Cunha,3,1,1,5,Ocasional
7679,6,1,7508.46,José Pedro Nogueira,4,1,4,9,Regular
7680,11,4,4451.07,Alice Aparecida,4,2,3,9,Regular
7681,17,4,1980.3899999999999,Benício Alves,4,2,1,7,Regular
7682,118,3,8492.93,Valentim Brito,1,1,4,6,Ocasional
7683,306,1,5544.66,Kamilly Novaes,1,1,3,5,Ocasional
7684,12,6,4019.5299999999997,Pedro Miguel Rezende,4,3,2,9,Regular
7685,6,7,8901.91,Bernardo Correia,4,4,4,12,VIP
7686,40,4,4773.54,Bella Mendes,3,2,3,8,Regular
7687,45,4,1891.16,Paulo Garcia,2,2,1,5,Ocasional
7688,179,4,6819.84,Dr. Rafael Pimenta,1,2,3,6,Ocasional
7689,66,6,4014.2200000000003,Thales Cassiano,2,3,2,7,Regular
7690,61,1,1853.5,Leandro Novaes,2,1,1,4,Ocasional
7691,41,3,2836.63,Nathan Fogaça,3,1,2,6,Ocasional
7692,50,2,2069.74,Gabriel Rodrigues,2,1,1,4,Ocasional
7693,46,4,5362.45,Ana Laura Campos,2,2,3,7,Regular
7694,4,7,2540.66,Lucca Moraes,4,4,2,10,VIP
7695,94,3,915.92,Luna Oliveira,1,1,1,3,Inativo
7696,53,5,11514.880000000001,Dom da Luz,2,3,4,9,Regular
7697,26,8,3672.14,Bella Fonseca,3,4,2,9,Regular
7698,62,5,3340.04,Antônio da Luz,2,3,2,7,Regular
7699,32,6,9196.3,Dante Moura,3,3,4,10,VIP
7700,55,3,2916.48,Alice Moura,2,1,2,5,Ocasional
7701,308,2,2787.31,Benjamim Alves,1,1,2,4,Ocasional
7703,12,6,11391.369999999999,Luiz Miguel Machado,4,3,4,11,VIP
7704,85,4,5448.79,Melina Nascimento,2,2,3,7,Regular
7705,54,5,10711.38,Lara da Costa,2,3,4,9,Regular
7706,21,5,6582.42,Maitê Macedo,3,3,3,9,Regular
7707,34,3,638.0,Maria Eduarda Garcia,3,1,1,5,Ocasional
7708,10,8,10352.09,Vicente Cassiano,4,4,4,12,VIP
7709,113,4,8838.789999999999,Yago Rezende,1,2,4,7,Regular
7710,48,6,6636.53,Eduardo Abreu,2,3,3,8,Regular
7711,110,4,5439.759999999999,Laura Melo,1,2,3,6,Ocasional
7712,231,2,622.5699999999999,Nicolas Brito,1,1,1,3,Inativo
7713,31,6,11791.23,Sra. Pietra Viana,3,3,4,10,VIP
7714,18,4,4623.3,Pedro Rezende,4,2,3,9,Regular
7715,81,5,2315.32,Pedro Miguel Silveira,2,3,2,7,Regular
7716,232,3,7288.21,Rafael da Paz,1,1,3,5,Ocasional
7717,102,5,5305.87,Raquel Cunha,1,3,3,7,Regular
7718,157,5,2541.0499999999997,Hellena Almeida,1,3,2,6,Ocasional
7719,46,5,11761.64,Emanuelly da Mota,2,3,4,9,Regular
7720,21,7,10783.97,Renan Rocha,3,4,4,11,VIP
7721,61,5,4014.66,Srta. Nina Cavalcanti,2,3,2,7,Regular
7722,61,4,5860.51,Luiz Miguel Vieira,2,2,3,7,Regular
7723,42,9,10632.650000000001,Mariah Mendes,3,4,4,11,VIP
7724,38,6,6815.150000000001,Stephany Vargas,3,3,3,9,Regular
7725,28,4,904.5,Maria Eduarda Caldeira,3,2,1,6,Ocasional
7726,54,3,1482.61,Gustavo Henrique Rodrigues,2,1,1,4,Ocasional
7727,165,5,14427.400000000001,Pedro Farias,1,3,4,8,Regular
7728,65,6,13089.529999999999,Srta. Bella Duarte,2,3,4,9,Regular
7729,59,4,2735.75,Maria Cecília Sales,2,2,2,6,Ocasional
7730,58,8,13314.0,Camila Pereira,2,4,4,10,VIP
7731,25,3,9706.68,Ana Lívia Cavalcanti,3,1,4,8,Regular
7732,43,7,5314.889999999999,Nina Ramos,3,4,3,10,VIP
7733,19,4,5604.07,Anna Liz Novaes,4,2,3,9,Regular
7734,275,1,99.14,Caio Araújo,1,1,1,3,Inativo
7735,4,3,2190.97,Davi Lucca Andrade,4,1,1,6,Ocasional
7736,39,4,7741.54,Ana Luiza Correia,3,2,4,9,Regular
7737,41,7,17576.89,Kamilly Nascimento,3,4,4,11,VIP
7738,71,4,539.27,Alice Araújo,2,2,1,5,Ocasional
7739,1,9,5238.83,Ana Clara Cavalcante,4,4,3,11,VIP
7740,16,4,4194.29,Erick Andrade,4,2,2,8,Regular
7741,5,6,12296.26,Esther Marques,4,3,4,11,VIP
7742,126,6,4247.06,Benjamim Albuquerque,1,3,2,6,Ocasional
7743,22,6,6992.44,Mathias Carvalho,3,3,3,9,Regular
7744,155,4,4181.81,Juliana Pastor,1,2,2,5,Ocasional
7745,39,3,3306.06,Anthony Gabriel Sousa,3,1,2,6,Ocasional
7746,18,3,1046.3100000000002,Sr. Francisco Almeida,4,1,1,6,Ocasional
7747,46,3,1064.5,Rebeca Castro,2,1,1,4,Ocasional
7748,44,1,312.2,Breno Souza,2,1,1,4,Ocasional
7749,90,4,4593.98,Diego Ramos,1,2,3,6,Ocasional
7750,1,7,7272.1900000000005,Isabella Teixeira,4,4,3,11,VIP
7751,112,7,11292.710000000001,Lucca Machado,1,4,4,9,Regular
7752,76,3,2913.49,Igor Lopes,2,1,2,5,Ocasional
7753,91,4,3823.27,Ana Lívia Peixoto,1,2,2,5,Ocasional
7754,119,5,8833.52,Lucas Gabriel Casa Grande,1,3,4,8,Regular
7755,7,4,7548.52,Rebeca Costa,4,2,4,10,VIP
7756,59,7,3511.77,Olívia Sampaio,2,4,2,8,Regular
7757,75,8,10625.64,Davi Miguel Albuquerque,2,4,4,10,VIP
7758,70,6,14532.91,Srta. Luara Mendonça,2,3,4,9,Regular
7759,6,6,11761.289999999999,Valentim Cirino,4,3,4,11,VIP
7760,17,8,15535.57,Daniel Araújo,4,4,4,12,VIP
7761,50,7,8032.16,Gael Henrique Nogueira,2,4,4,10,VIP
7762,12,4,1918.16,Elisa Lima,4,2,1,7,Regular
7763,30,4,5448.990000000001,Maria Rocha,3,2,3,8,Regular
7764,10,5,3339.59,Liam Ribeiro,4,3,2,9,Regular
7765,74,6,15551.97,Ana Luiza Sampaio,2,3,4,9,Regular
7766,86,6,9228.16,João Vitor Gonçalves,2,3,4,9,Regular
7767,3,2,766.15,Francisco Alves,4,1,1,6,Ocasional
7768,170,4,7703.37,Ana Liz Pereira,1,2,4,7,Regular
7769,10,3,6022.48,Enrico da Mata,4,1,3,8,Regular
7770,153,4,8746.119999999999,Dr. Erick Costela,1,2,4,7,Regular
7771,101,4,5516.75,Isaac da Cunha,1,2,3,6,Ocasional
7772,209,3,6618.88,Isabella Nunes,1,1,3,5,Ocasional
7773,23,4,3556.7200000000003,Dr. Dom Novaes,3,2,2,7,Regular
7774,268,1,363.6,Francisco Gomes,1,1,1,3,Inativo
7775,3,1,5618.63,Bárbara Oliveira,4,1,3,8,Regular
7776,40,8,13440.32,João Felipe Silveira,3,4,4,11,VIP
7777,68,3,3903.5,Alícia Albuquerque,2,1,2,5,Ocasional
7778,120,5,5470.89,Letícia da Rosa,1,3,3,7,Regular
7779,18,7,11197.41,Maria Isis Rodrigues,4,4,4,12,VIP
7780,51,11,17313.84,Stephany Fernandes,2,4,4,10,VIP
7781,101,2,5053.33,Srta. Maria Alice Cavalcante,1,1,3,5,Ocasional
7782,150,2,2150.67,Sra. Helena Azevedo,1,1,1,3,Inativo
7783,192,2,872.3299999999999,Dr. Lucca Barbosa,1,1,1,3,Inativo
7784,6,4,805.8199999999999,Melissa Vasconcelos,4,2,1,7,Regular
7785,29,2,2475.94,Lorenzo Moraes,3,1,2,6,Ocasional
7786,124,4,7510.44,Sra. Maria Liz Sales,1,2,4,7,Regular
7787,51,1,456.57,Sr. Luiz Gustavo da Rosa,2,1,1,4,Ocasional
7788,38,4,2595.48,Benicio Porto,3,2,2,7,Regular
7789,42,3,6404.63,Liam Martins,3,1,3,7,Regular
7790,97,3,3592.02,Luana Porto,1,1,2,4,Ocasional
7791,39,5,1297.86,Alexia Lopes,3,3,1,7,Regular
7792,92,3,4095.33,Dr. Lucca Lima,1,1,2,4,Ocasional
7793,42,5,3422.18,Fernando Melo,3,3,2,8,Regular
7794,52,7,6830.75,Maria Júlia da Cunha,2,4,3,9,Regular
7795,65,3,703.8199999999999,Arthur das Neves,2,1,1,4,Ocasional
7796,24,2,1313.3600000000001,Maria Flor Moraes,3,1,1,5,Ocasional
7797,106,4,4183.15,Jade da Luz,1,2,2,5,Ocasional
7798,77,7,9575.83,Diego Pires,2,4,4,10,VIP
7799,28,6,5261.72,Anthony Gabriel Abreu,3,3,3,9,Regular
7800,30,5,5479.04,Luana Sampaio,3,3,3,9,Regular
7801,4,3,1923.8,Dr. Anthony Gabriel Barros,4,1,1,6,Ocasional
7802,57,3,1454.35,Srta. Luiza Leão,2,1,1,4,Ocasional
7803,60,4,6135.33,Josué Siqueira,2,2,3,7,Regular
7804,172,3,911.9200000000001,Ian Garcia,1,1,1,3,Inativo
7805,44,3,3415.0,Maria Fernanda Gonçalves,2,1,2,5,Ocasional
7806,48,8,11499.86,Dr. Oliver Machado,2,4,4,10,VIP
7807,32,2,2653.32,João Gabriel da Costa,3,1,2,6,Ocasional
7808,63,7,7391.95,Srta. Manuella Barros,2,4,4,10,VIP
7809,8,5,3784.2900000000004,Caio Barros,4,3,2,9,Regular
7810,86,5,7504.06,Isaque Vargas,2,3,4,9,Regular
7811,49,2,2651.16,Pietra Casa Grande,2,1,2,5,Ocasional
7812,2,7,4063.49,Théo da Paz,4,4,2,10,VIP
7813,33,6,7396.24,Rael da Paz,3,3,4,10,VIP
7814,38,4,4937.18,Stella Santos,3,2,3,8,Regular
7815,115,2,2487.34,Maria Borges,1,1,2,4,Ocasional
7816,14,7,12460.23,Guilherme Andrade,4,4,4,12,VIP
7817,16,5,16883.81,Sr. Henrique Rios,4,3,4,11,VIP
7818,40,3,5353.8,Juan Monteiro,3,1,3,7,Regular
7819,69,1,757.32,Ana da Rocha,2,1,1,4,Ocasional
7820,46,4,6786.75,Letícia Teixeira,2,2,3,7,Regular
7821,3,4,5357.08,Maria Clara Pinto,4,2,3,9,Regular
7822,16,4,3308.39,Nina da Rosa,4,2,2,8,Regular
7823,160,3,6955.22,Pedro Miguel da Paz,1,1,3,5,Ocasional
7824,108,2,1225.56,Alana Pacheco,1,1,1,3,Inativo
7825,11,4,2759.62,Valentina Rodrigues,4,2,2,8,Regular
7826,118,3,4286.35,Sra. Isabel Pacheco,1,1,2,4,Ocasional
7827,7,5,6903.99,Srta. Pietra da Conceição,4,3,3,10,VIP
7828,122,3,3399.56,Rebeca Sales,1,1,2,4,Ocasional
7829,23,3,862.4200000000001,Raquel Dias,3,1,1,5,Ocasional
7830,24,3,2788.81,Amanda da Rocha,3,1,2,6,Ocasional
7832,55,2,3586.86,Ryan Araújo,2,1,2,5,Ocasional
7833,204,2,2533.86,Fernanda Moraes,1,1,2,4,Ocasional
7834,30,4,6370.280000000001,Sr. Luiz Gustavo Sousa,3,2,3,8,Regular
7835,27,3,2373.27,João Pedro Silveira,3,1,2,6,Ocasional
7836,5,8,9711.82,Jade Alves,4,4,4,12,VIP
7837,162,3,4874.03,Pedro Montenegro,1,1,3,5,Ocasional
7838,7,8,10145.3,Antônio Câmara,4,4,4,12,VIP
7839,4,8,19910.510000000002,Sr. Lorenzo Rios,4,4,4,12,VIP
7840,28,4,7718.68,Srta. Zoe Barros,3,2,4,9,Regular
7841,21,3,3598.67,Davi Lucas Aragão,3,1,2,6,Ocasional
7842,26,4,2890.56,Daniela Mendes,3,2,2,7,Regular
7843,15,4,1454.06,Heloísa Sá,4,2,1,7,Regular
7844,12,8,4592.61,Felipe Pacheco,4,4,3,11,VIP
7845,109,6,17280.44,Dante Melo,1,3,4,8,Regular
7846,106,5,5306.049999999999,Camila Peixoto,1,3,3,7,Regular
7847,27,8,14141.98,Jade Caldeira,3,4,4,11,VIP
7848,30,7,2601.2000000000003,Srta. Ana Carolina Borges,3,4,2,9,Regular
7849,28,6,8458.029999999999,Diogo Vargas,3,3,4,10,VIP
7850,3,2,7115.45,Eloah Araújo,4,1,3,8,Regular
7851,138,4,3520.93,Allana Martins,1,2,2,5,Ocasional
7852,16,6,10423.44,Vitória Santos,4,3,4,11,VIP
7853,45,3,905.1800000000001,Sophia Rodrigues,2,1,1,4,Ocasional
7854,16,7,12486.4,Bianca Fogaça,4,4,4,12,VIP
7855,88,2,1057.04,Srta. Amanda Cavalcanti,1,1,1,3,Inativo
7856,34,9,6861.06,Sra. Ana Luiza Jesus,3,4,3,10,VIP
7857,4,6,4565.85,Melina Rocha,4,3,3,10,VIP
7858,70,2,81.66,Vitor Albuquerque,2,1,1,4,Ocasional
7859,13,4,2968.42,Bianca Silva,4,2,2,8,Regular
7860,16,5,7379.009999999999,Laís Andrade,4,3,4,11,VIP
7861,235,3,834.71,Mariana Pacheco,1,1,1,3,Inativo
7862,23,5,11702.83,Samuel Machado,3,3,4,10,VIP
7863,48,2,3690.65,Mariana Cavalcanti,2,1,2,5,Ocasional
7864,79,3,8107.47,Lorena Freitas,2,1,4,7,Regular
7865,58,5,5668.48,Srta. Maria Luiza Pereira,2,3,3,8,Regular
7866,15,4,9496.619999999999,Helena Aparecida,4,2,4,10,VIP
7867,59,4,6548.8,Arthur Gabriel Cirino,2,2,3,7,Regular
7868,76,2,2823.13,Otto Moreira,2,1,2,5,Ocasional
7869,35,4,3241.5099999999998,Josué Sampaio,3,2,2,7,Regular
7870,7,6,7196.14,Nicole Fogaça,4,3,3,10,VIP
7871,91,5,795.9200000000001,Yago Barbosa,1,3,1,5,Ocasional
7872,30,6,2845.73,Davi Luiz Vargas,3,3,2,8,Regular
7873,48,4,1255.65,Liam Nascimento,2,2,1,5,Ocasional
7874,5,5,4334.610000000001,Maria Alice Nogueira,4,3,2,9,Regular
7875,98,2,1694.8999999999999,Thomas Farias,1,1,1,3,Inativo
7876,50,3,4611.78,Nicolas Silva,2,1,3,6,Ocasional
7877,66,6,3427.69,Manuela Dias,2,3,2,7,Regular
7878,34,4,5114.400000000001,Matteo Sampaio,3,2,3,8,Regular
7879,1,4,2954.7,Isaque Martins,4,2,2,8,Regular
7880,15,3,2953.61,Igor Camargo,4,1,2,7,Regular
7881,37,3,3395.2900000000004,Breno Teixeira,3,1,2,6,Ocasional
7882,25,7,13775.47,Davi Miguel Fogaça,3,4,4,11,VIP
7883,187,2,1543.68,Srta. Maria Luísa Oliveira,1,1,1,3,Inativo
7884,3,7,8750.039999999999,Nina Santos,4,4,4,12,VIP
7885,30,2,2624.07,Dr. Antônio Nunes,3,1,2,6,Ocasional
7886,3,5,4208.62,Elisa Guerra,4,3,2,9,Regular
7887,91,2,7106.42,Bianca Sampaio,1,1,3,5,Ocasional
7888,203,1,1988.37,Sarah Brito,1,1,1,3,Inativo
7889,154,6,9462.919999999998,Nina Cardoso,1,3,4,8,Regular
7890,65,4,2360.85,Raquel Ramos,2,2,2,6,Ocasional
7891,4,8,13632.560000000001,Evelyn da Rocha,4,4,4,12,VIP
7892,289,2,1163.01,Heloisa Fogaça,1,1,1,3,Inativo
7893,87,4,2428.1400000000003,Sra. Lívia Ribeiro,2,2,2,6,Ocasional
7894,32,3,4306.23,Marcos Vinicius Rodrigues,3,1,2,6,Ocasional
7895,18,4,3316.67,Lunna Pinto,4,2,2,8,Regular
7896,19,7,13247.94,João Miguel Camargo,4,4,4,12,VIP
7897,53,3,6635.389999999999,Daniel Vieira,2,1,3,6,Ocasional
7898,13,6,5964.95,Sophie da Rosa,4,3,3,10,VIP
7899,4,4,3831.06,Luiz Henrique Rodrigues,4,2,2,8,Regular
7900,13,4,5605.07,Dra. Maria Liz Andrade,4,2,3,9,Regular
7901,40,5,9084.24,José Miguel da Cunha,3,3,4,10,VIP
7902,67,5,9422.66,Melina Albuquerque,2,3,4,9,Regular
7903,18,7,7807.570000000001,Aurora Fernandes,4,4,4,12,VIP
7904,45,3,6908.23,João Guilherme Lima,2,1,3,6,Ocasional
7905,37,4,8125.41,Leandro Siqueira,3,2,4,9,Regular
7906,117,5,5248.24,Ana Liz Farias,1,3,3,7,Regular
7907,6,4,4728.52,Noah Ribeiro,4,2,3,9,Regular
7908,6,9,8875.27,Oliver Santos,4,4,4,12,VIP
7909,74,2,1293.86,Ana Laura Costa,2,1,1,4,Ocasional
7910,51,6,5924.73,Sophia Caldeira,2,3,3,8,Regular
7911,54,2,2249.99,Larissa da Paz,2,1,1,4,Ocasional
7912,31,6,12406.640000000001,Amanda Lopes,3,3,4,10,VIP
7913,90,2,1043.67,Ana Martins,1,1,1,3,Inativo
7914,23,5,2600.1,Camila Cardoso,3,3,2,8,Regular
7915,136,5,6364.549999999999,Lunna Silva,1,3,3,7,Regular
7916,89,5,3362.83,Lavínia Azevedo,1,3,2,6,Ocasional
7917,55,4,5901.0199999999995,Dr. Davi Lucas Ribeiro,2,2,3,7,Regular
7918,106,4,6390.110000000001,Lorenzo Sousa,1,2,3,6,Ocasional
7919,25,7,9007.08,João Pedro Almeida,3,4,4,11,VIP
7920,56,4,1254.95,Maria Sophia Moreira,2,2,1,5,Ocasional
7921,226,2,1006.66,Bárbara Guerra,1,1,1,3,Inativo
7922,1,8,9357.69,Ana Cecília da Rocha,4,4,4,12,VIP
7923,3,3,1446.77,Carlos Eduardo Barbosa,4,1,1,6,Ocasional
7924,31,5,13773.8,Olivia Montenegro,3,3,4,10,VIP
7925,16,4,13477.929999999998,Lavínia da Conceição,4,2,4,10,VIP
7926,91,1,2398.12,Gael Henrique Nunes,1,1,2,4,Ocasional
7927,27,3,2682.58,José Pedro da Cunha,3,1,2,6,Ocasional
7928,33,2,5092.450000000001,Luara Porto,3,1,3,7,Regular
7929,4,3,3913.43,Maria Isis Lopes,4,1,2,7,Regular
7930,26,3,4076.37,Nathan Ramos,3,1,2,6,Ocasional
7931,10,3,12013.72,Dr. Vicente Aparecida,4,1,4,9,Regular
7932,324,1,378.87,Isabela Guerra,1,1,1,3,Inativo
7933,41,4,670.63,Stephany Pires,3,2,1,6,Ocasional
7934,22,2,771.39,Igor Cavalcanti,3,1,1,5,Ocasional
7935,34,5,7213.1,Benjamin Gomes,3,3,3,9,Regular
7936,29,4,7719.19,Gael Henrique Garcia,3,2,4,9,Regular
7937,132,5,1221.56,Sra. Ísis Nogueira,1,3,1,5,Ocasional
7938,13,3,3210.3999999999996,Sarah Freitas,4,1,2,7,Regular
7939,3,6,3545.9300000000003,Ana Vitória Moura,4,3,2,9,Regular
7940,46,7,8543.13,Beatriz Fonseca,2,4,4,10,VIP
7941,130,3,4548.52,Henrique Jesus,1,1,3,5,Ocasional
7942,4,8,7794.09,Bella da Costa,4,4,4,12,VIP
7943,39,2,1548.71,Maria Alice Garcia,3,1,1,5,Ocasional
7944,1,2,555.5,José Pedro da Cruz,4,1,1,6,Ocasional
7945,18,9,15557.06,Luan Caldeira,4,4,4,12,VIP
7946,95,4,2775.49,Lorenzo Câmara,1,2,2,5,Ocasional
7947,3,7,8398.619999999999,Rodrigo Lopes,4,4,4,12,VIP
7948,61,1,1313.86,Lara Jesus,2,1,1,4,Ocasional
7949,147,3,4016.8700000000003,Clarice Mendonça,1,1,2,4,Ocasional
7950,5,5,12430.25,Benjamin Lima,4,3,4,11,VIP
7951,37,9,7772.04,Srta. Alana Sampaio,3,4,4,11,VIP
7952,71,5,3658.38,Arthur Gabriel Borges,2,3,2,7,Regular
7953,58,4,4961.38,João Gabriel Nogueira,2,2,3,7,Regular
7954,44,3,1320.15,Isabelly Fonseca,2,1,1,4,Ocasional
7955,9,4,543.0999999999999,Sra. Amanda Pires,4,2,1,7,Regular
7956,41,1,3300.87,Sr. Bernardo Farias,3,1,2,6,Ocasional
7957,8,2,7487.150000000001,Maria Sophia Cavalcante,4,1,4,9,Regular
7958,74,4,6400.8099999999995,Sr. Caleb Cardoso,2,2,3,7,Regular
7959,24,3,3408.9600000000005,Júlia da Rocha,3,1,2,6,Ocasional
7960,67,3,6253.8099999999995,Nina Cirino,2,1,3,6,Ocasional
7961,93,10,10440.64,Srta. Bianca Ramos,1,4,4,9,Regular
7962,48,3,3501.0600000000004,Vinícius Fernandes,2,1,2,5,Ocasional
7963,85,4,1264.5700000000002,Sr. Liam Fonseca,2,2,1,5,Ocasional
7964,36,4,7166.41,Cecilia Vieira,3,2,3,8,Regular
7965,61,5,3053.15,Rebeca da Costa,2,3,2,7,Regular
7966,39,7,6753.99,Luiz Fernando Almeida,3,4,3,10,VIP
7967,126,2,1906.73,Sr. Miguel Silva,1,1,1,3,Inativo
7968,21,3,3196.5099999999998,Maria Rezende,3,1,2,6,Ocasional
7969,4,5,9805.619999999999,Felipe Sá,4,3,4,11,VIP
7970,13,2,7931.18,Sabrina Costela,4,1,4,9,Regular
7971,269,1,2952.1,Anthony Gabriel da Mata,1,1,2,4,Ocasional
7972,33,7,5531.66,Catarina Montenegro,3,4,3,10,VIP
7973,112,3,1702.08,Ravi Lucca Machado,1,1,1,3,Inativo
7974,27,5,5800.94,Clara Porto,3,3,3,9,Regular
7975,25,8,16316.76,Marcela Oliveira,3,4,4,11,VIP
7976,2,8,8198.59,Isis Caldeira,4,4,4,12,VIP
7977,32,7,2486.6,Sr. Matteo Nunes,3,4,2,9,Regular
7978,262,2,3226.43,Laura Pacheco,1,1,2,4,Ocasional
7979,122,4,4926.98,Cecília da Mota,1,2,3,6,Ocasional
7980,124,3,3813.96,Vicente Farias,1,1,2,4,Ocasional
7981,242,2,996.0799999999999,Kaique Cavalcante,1,1,1,3,Inativo
7982,50,3,4484.33,Dr. Juan Barros,2,1,3,6,Ocasional
7983,133,3,796.52,Emanuel Siqueira,1,1,1,3,Inativo
7984,92,5,3875.17,Sra. Maria Abreu,1,3,2,6,Ocasional
7985,3,3,2616.48,Dr. João Lucas Novaes,4,1,2,7,Regular
7986,58,5,8386.41,Eduardo Garcia,2,3,4,9,Regular
7988,183,1,1146.87,Thiago Vieira,1,1,1,3,Inativo
7989,288,1,199.34,Isabel Sousa,1,1,1,3,Inativo
7990,35,2,2480.54,Calebe Guerra,3,1,2,6,Ocasional
7991,29,2,1870.3400000000001,Pietra Sales,3,1,1,5,Ocasional
7992,185,1,234.43,Léo Almeida,1,1,1,3,Inativo
7993,47,5,2171.62,Bryan Nascimento,2,3,1,6,Ocasional
7994,55,5,6668.639999999999,Sra. Emanuella Pacheco,2,3,3,8,Regular
7995,111,1,1466.29,Fernanda Aragão,1,1,1,3,Inativo
7996,136,4,3618.32,Amanda Casa Grande,1,2,2,5,Ocasional
7997,148,2,4000.57,Matheus Cassiano,1,1,2,4,Ocasional
7998,18,5,2541.94,Alícia Azevedo,4,3,2,9,Regular
7999,8,9,6471.56,João Guilherme das Neves,4,4,3,11,VIP
8000,47,3,3485.35,Caroline Andrade,2,1,2,5,Ocasional
8001,83,5,4459.21,Dr. Augusto da Rocha,2,3,3,8,Regular
8002,73,4,6026.23,Ana Campos,2,2,3,7,Regular
8003,21,5,5199.96,Valentim Vasconcelos,3,3,3,9,Regular
8004,120,1,888.67,Rebeca Guerra,1,1,1,3,Inativo
8005,18,6,9388.99,Danilo Albuquerque,4,3,4,11,VIP
8006,243,3,4593.0199999999995,Heitor Fonseca,1,1,3,5,Ocasional
8007,137,3,2457.81,Larissa Nunes,1,1,2,4,Ocasional
8008,40,3,2575.2,Dra. Ana Sophia Barros,3,1,2,6,Ocasional
8009,44,4,6667.68,Maria Helena Gonçalves,2,2,3,7,Regular
8010,87,3,6290.56,Ágatha Carvalho,2,1,3,6,Ocasional
8011,6,6,3010.9,Liz Montenegro,4,3,2,9,Regular
8012,33,4,5293.44,Thomas Teixeira,3,2,3,8,Regular
8013,2,3,2514.22,Guilherme Campos,4,1,2,7,Regular
8014,31,5,5374.39,Gabriel Castro,3,3,3,9,Regular
8015,63,3,4767.63,Caleb Teixeira,2,1,3,6,Ocasional
8016,82,4,5657.58,Eduarda Alves,2,2,3,7,Regular
8018,109,3,1260.99,Sr. Vitor Gabriel Duarte,1,1,1,3,Inativo
8019,46,2,215.87,Apollo Camargo,2,1,1,4,Ocasional
8020,22,7,5939.110000000001,Luna Pires,3,4,3,10,VIP
8021,313,2,3535.6099999999997,Enzo Montenegro,1,1,2,4,Ocasional
8022,189,2,554.63,Marcos Vinicius das Neves,1,1,1,3,Inativo
8023,92,3,5480.11,Ester Pires,1,1,3,5,Ocasional
8024,99,5,6065.200000000001,Natália Rios,1,3,3,7,Regular
8025,1,6,3163.58,Maitê Pacheco,4,3,2,9,Regular
8026,103,1,575.7,Clara Pinto,1,1,1,3,Inativo
8027,59,6,8854.94,Cecília Martins,2,3,4,9,Regular
8028,74,7,7541.6900000000005,Gabriel Lopes,2,4,4,10,VIP
8029,55,7,4154.97,Breno Sousa,2,4,2,8,Regular
8030,10,7,8906.89,Pedro Cirino,4,4,4,12,VIP
8031,5,4,6318.51,Isabel Oliveira,4,2,3,9,Regular
8032,6,8,5571.61,Paulo Almeida,4,4,3,11,VIP
8033,50,4,864.15,Bryan Melo,2,2,1,5,Ocasional
8034,8,4,8614.929999999998,Dra. Natália Rios,4,2,4,10,VIP
8035,16,8,14028.67,Benicio Pires,4,4,4,12,VIP
8036,18,3,1953.43,Srta. Maya Leão,4,1,1,6,Ocasional
8037,26,8,5861.7300000000005,Henrique Pastor,3,4,3,10,VIP
8038,27,5,4675.91,Igor Caldeira,3,3,3,9,Regular
8039,42,7,10287.16,Rodrigo Viana,3,4,4,11,VIP
8040,37,8,5194.67,Thiago Macedo,3,4,3,10,VIP
8041,9,5,8159.48,Beatriz Brito,4,3,4,11,VIP
8042,304,1,249.87,Thales da Mota,1,1,1,3,Inativo
8043,87,6,5065.06,Ana Liz Melo,2,3,3,8,Regular
8044,10,8,11734.7,Emanuel Cunha,4,4,4,12,VIP
8045,125,3,598.5699999999999,André Monteiro,1,1,1,3,Inativo
8046,16,6,6239.36,Dra. Eduarda Araújo,4,3,3,10,VIP
8047,29,6,3486.44,Rebeca Moura,3,3,2,8,Regular
8048,62,3,3412.75,Cauã Azevedo,2,1,2,5,Ocasional
8049,19,2,3247.41,Luara da Cruz,4,1,2,7,Regular
8050,41,7,12286.54,Giovanna Vargas,3,4,4,11,VIP
8051,10,8,9948.75,Matheus Vieira,4,4,4,12,VIP
8052,7,3,6339.120000000001,Bruna Montenegro,4,1,3,8,Regular
8053,54,1,729.82,Isabella Rezende,2,1,1,4,Ocasional
8054,28,2,2865.66,Marcos Vinicius Cardoso,3,1,2,6,Ocasional
8055,35,9,4780.21,Gustavo Casa Grande,3,4,3,10,VIP
8056,45,9,16083.800000000001,Caleb Dias,2,4,4,10,VIP
8057,19,6,7636.8,Antônio Casa Grande,4,3,4,11,VIP
8058,40,3,2440.55,Anthony da Mota,3,1,2,6,Ocasional
8059,1,3,2915.89,Bruno Andrade,4,1,2,7,Regular
8060,10,6,7007.24,Ian Silva,4,3,3,10,VIP
8061,136,1,1930.74,Nina da Mota,1,1,1,3,Inativo
8062,41,5,1860.73,Ravi Lucca Martins,3,3,1,7,Regular
8063,285,3,3347.34,Aurora Marques,1,1,2,4,Ocasional
8064,70,6,4995.150000000001,Luísa Siqueira,2,3,3,8,Regular
8065,5,9,5155.629999999999,Kamilly Nascimento,4,4,3,11,VIP
8066,48,1,147.92,Esther Rocha,2,1,1,4,Ocasional
8067,96,2,883.8499999999999,Cauã Vieira,1,1,1,3,Inativo
8068,2,5,2231.69,Mirella Câmara,4,3,1,8,Regular
8069,101,5,7419.88,Srta. Mariana Rezende,1,3,4,8,Regular
8070,292,2,389.84000000000003,Dr. Cauã Freitas,1,1,1,3,Inativo
8071,179,3,3316.8599999999997,João Guilherme Carvalho,1,1,2,4,Ocasional
8072,193,3,6316.88,João Guilherme Silveira,1,1,3,5,Ocasional
8073,16,3,4260.86,Sabrina Sales,4,1,2,7,Regular
8074,309,3,6471.51,João Miguel Monteiro,1,1,3,5,Ocasional
8075,63,7,7994.340000000001,Dra. Ana Clara Vargas,2,4,4,10,VIP
8077,26,4,1362.56,Julia Nunes,3,2,1,6,Ocasional
8078,66,5,4728.14,Maria Vitória Novais,2,3,3,8,Regular
8079,28,3,4607.17,Sra. Maya da Cunha,3,1,3,7,Regular
8080,23,4,2248.16,Vitor Gabriel Pimenta,3,2,1,6,Ocasional
8081,40,1,346.93,Olivia Rodrigues,3,1,1,5,Ocasional
8082,26,5,5757.56,Ana Liz Silveira,3,3,3,9,Regular
8083,21,4,3251.77,Brenda Costa,3,2,2,7,Regular
8084,38,5,4666.85,Bruno Silveira,3,3,3,9,Regular
8085,13,4,958.2599999999999,Bianca Santos,4,2,1,7,Regular
8086,155,2,1939.22,Sr. Murilo Mendonça,1,1,1,3,Inativo
8087,5,6,5266.41,Liam Jesus,4,3,3,10,VIP
8088,1,6,10028.01,Hellena Cassiano,4,3,4,11,VIP
8089,8,6,6382.4400000000005,Emilly Guerra,4,3,3,10,VIP
8090,45,1,41.45,Sra. Cecilia Fernandes,2,1,1,4,Ocasional
8091,82,6,4029.3700000000003,Lívia Nunes,2,3,2,7,Regular
8092,36,5,14911.15,Luan Sampaio,3,3,4,10,VIP
8093,32,4,6357.879999999999,Sr. Benício Santos,3,2,3,8,Regular
8094,68,3,503.22,Luiz Fernando Pinto,2,1,1,4,Ocasional
8095,154,6,1485.1399999999999,Sra. Mariana Pastor,1,3,1,5,Ocasional
8096,37,7,9846.02,Hellena Santos,3,4,4,11,VIP
8097,10,5,7358.13,Juan Nunes,4,3,4,11,VIP
8098,29,5,6789.9800000000005,Isis Siqueira,3,3,3,9,Regular
8099,4,3,4259.47,Maria Cecília Aparecida,4,1,2,7,Regular
8100,39,7,5181.08,Vitor Hugo Pires,3,4,3,10,VIP
8101,63,6,3261.74,Srta. Melina Porto,2,3,2,7,Regular
8102,83,2,2484.7400000000002,João Vitor Oliveira,2,1,2,5,Ocasional
8103,1,6,6119.09,Dom Mendes,4,3,3,10,VIP
8104,56,3,1548.04,Arthur Andrade,2,1,1,4,Ocasional
8105,17,5,5314.73,Dr. Luiz Felipe da Luz,4,3,3,10,VIP
8106,67,5,2081.31,Gael Vasconcelos,2,3,1,6,Ocasional
8107,122,2,704.41,Sr. Luiz Miguel Oliveira,1,1,1,3,Inativo
8108,6,4,2996.5099999999998,Yago Sousa,4,2,2,8,Regular
8109,272,2,3835.34,Fernando Freitas,1,1,2,4,Ocasional
8110,315,2,1099.58,Lucca Nascimento,1,1,1,3,Inativo
8111,84,5,10482.95,Pedro Henrique Jesus,2,3,4,9,Regular
8112,66,5,5186.26,Murilo Campos,2,3,3,8,Regular
8113,38,4,3166.57,Theodoro Alves,3,2,2,7,Regular
8114,225,3,2571.7,Leonardo Alves,1,1,2,4,Ocasional
8115,7,6,4363.61,Dante Novaes,4,3,2,9,Regular
8116,50,6,3025.48,Srta. Gabrielly Cardoso,2,3,2,7,Regular
8117,36,4,5790.84,Sra. Isis Pinto,3,2,3,8,Regular
8118,164,2,718.99,Gabriela Gonçalves,1,1,1,3,Inativo
8119,12,2,2620.95,André Pinto,4,1,2,7,Regular
8120,47,7,11633.76,Theodoro Nogueira,2,4,4,10,VIP
8121,287,2,6034.34,Ana Lívia Novais,1,1,3,5,Ocasional
8122,65,4,7522.53,Antony da Luz,2,2,4,8,Regular
8123,64,5,5247.06,Davi Lucas Teixeira,2,3,3,8,Regular
8124,88,3,5383.24,João Guilherme Fonseca,1,1,3,5,Ocasional
8126,5,5,13274.74,Dr. Gael Henrique Pimenta,4,3,4,11,VIP
8127,57,5,5155.72,Isis Ribeiro,2,3,3,8,Regular
8128,12,4,1939.52,Isabela Almeida,4,2,1,7,Regular
8129,22,4,2361.54,Davi Miguel Campos,3,2,2,7,Regular
8130,4,9,8994.04,Isaac Cardoso,4,4,4,12,VIP
8131,31,4,6391.389999999999,Murilo das Neves,3,2,3,8,Regular
8132,82,3,1141.67,Rhavi Camargo,2,1,1,4,Ocasional
8133,3,7,2795.98,Dr. Nicolas Rios,4,4,2,10,VIP
8134,71,2,4155.34,Carlos Eduardo Silva,2,1,2,5,Ocasional
8135,172,4,6977.34,Yasmin Andrade,1,2,3,6,Ocasional
8136,206,1,874.16,Maria Luiza Costela,1,1,1,3,Inativo
8137,54,4,2907.82,Arthur Miguel Pacheco,2,2,2,6,Ocasional
8138,10,5,6556.150000000001,Sr. Luiz Miguel Monteiro,4,3,3,10,VIP
8139,40,3,3155.1800000000003,Maria Alice Souza,3,1,2,6,Ocasional
8140,54,5,1018.76,Leonardo Castro,2,3,1,6,Ocasional
8141,34,4,2423.25,Ana Cecília Pinto,3,2,2,7,Regular
8142,50,2,1285.7,Clara Montenegro,2,1,1,4,Ocasional
8143,34,6,12274.45,Vitor Hugo Freitas,3,3,4,10,VIP
8144,151,4,2289.9900000000002,Evelyn Pereira,1,2,2,5,Ocasional
8145,32,3,2354.41,Caio Martins,3,1,2,6,Ocasional
8146,1,5,5554.04,Maria Eduarda Rezende,4,3,3,10,VIP
8147,26,4,3065.92,Maria Clara Cavalcante,3,2,2,7,Regular
8148,78,5,13619.829999999998,Sra. Manuella Peixoto,2,3,4,9,Regular
8149,31,4,1419.53,Cauã da Cruz,3,2,1,6,Ocasional
8150,15,6,13449.03,Hadassa Garcia,4,3,4,11,VIP
8151,18,4,3056.73,Alana Câmara,4,2,2,8,Regular
8152,29,11,14485.28,Benício Mendes,3,4,4,11,VIP
8153,1,4,5588.33,Julia Pacheco,4,2,3,9,Regular
8154,18,2,1844.3600000000001,Maria Helena Garcia,4,1,1,6,Ocasional
8155,128,8,14496.810000000001,Olívia Alves,1,4,4,9,Regular
8156,43,3,1443.49,Gustavo Melo,3,1,1,5,Ocasional
8157,59,7,3446.6,Sr. Henrique Cunha,2,4,2,8,Regular
8158,173,4,3786.48,Otto da Cruz,1,2,2,5,Ocasional
8159,2,2,7213.709999999999,Arthur Miguel Cavalcanti,4,1,3,8,Regular
8160,74,3,3258.27,Rafael Pinto,2,1,2,5,Ocasional
8161,40,8,10289.39,Pietro Pires,3,4,4,11,VIP
8162,54,2,744.22,Calebe da Rosa,2,1,1,4,Ocasional
8163,167,5,8561.390000000001,Liz Mendonça,1,3,4,8,Regular
8165,88,3,13328.529999999999,Sr. Otávio Dias,1,1,4,6,Ocasional
8166,62,1,41.72,Cecilia Dias,2,1,1,4,Ocasional
8167,46,3,1061.5600000000002,Cauã Silva,2,1,1,4,Ocasional
8168,8,2,6790.54,Lucas Pimenta,4,1,3,8,Regular
8169,80,3,1658.83,Dr. Fernando Camargo,2,1,1,4,Ocasional
8170,37,5,1946.4799999999998,Bruno Brito,3,3,1,7,Regular
8171,69,2,1888.52,Liz Araújo,2,1,1,4,Ocasional
8172,33,3,4066.02,Maria Isis Fogaça,3,1,2,6,Ocasional
8173,22,4,5225.71,Sr. Gabriel Pires,3,2,3,8,Regular
8174,1,4,1200.38,Dra. Ágatha Duarte,4,2,1,7,Regular
8175,55,2,1203.43,Sr. Thales Leão,2,1,1,4,Ocasional
8176,78,6,10394.07,Antony Ribeiro,2,3,4,9,Regular
8177,91,2,1083.7,Henry Pacheco,1,1,1,3,Inativo
8178,8,4,3546.25,Lara da Paz,4,2,2,8,Regular
8179,81,2,5234.04,Luana Castro,2,1,3,6,Ocasional
8180,80,5,6424.96,Vitor Hugo Aragão,2,3,3,8,Regular
8181,25,3,4756.25,Breno Ribeiro,3,1,3,7,Regular
8182,6,5,5609.83,Dra. Elisa Cirino,4,3,3,10,VIP
8183,89,6,8012.52,Anna Liz Marques,1,3,4,8,Regular
8184,51,6,9477.76,Ana Lívia Azevedo,2,3,4,9,Regular
8185,9,7,17378.25,Brenda Caldeira,4,4,4,12,VIP
8186,13,9,5533.0,Lucca Sousa,4,4,3,11,VIP
8187,79,4,3838.28,Evelyn Moraes,2,2,2,6,Ocasional
8188,73,3,4279.36,Juan Ramos,2,1,2,5,Ocasional
8189,161,3,1677.3,Daniel Pimenta,1,1,1,3,Inativo
8190,33,5,2554.83,Luiz Fernando da Rosa,3,3,2,8,Regular
8191,51,3,4112.65,Enzo Gabriel Barbosa,2,1,2,5,Ocasional
8192,66,1,281.42,Valentina Costa,2,1,1,4,Ocasional
8193,19,5,7242.49,Dr. Benício Duarte,4,3,3,10,VIP
8194,48,5,1830.81,Sr. Francisco Camargo,2,3,1,6,Ocasional
8195,74,2,290.58,Stephany Cardoso,2,1,1,4,Ocasional
8196,12,8,6486.35,José Miguel Sousa,4,4,3,11,VIP
8197,129,3,4253.3,Lucca Cunha,1,1,2,4,Ocasional
8198,103,2,2084.74,Kamilly da Mata,1,1,1,3,Inativo
8199,192,2,2949.3900000000003,Yago Nascimento,1,1,2,4,Ocasional
8200,4,5,4568.46,Emilly Farias,4,3,3,10,VIP
8201,33,4,3496.67,Elisa Vieira,3,2,2,7,Regular
8202,61,5,10983.55,Eloah Moreira,2,3,4,9,Regular
8203,52,4,5404.66,Marcos Vinicius Cavalcante,2,2,3,7,Regular
8204,36,3,6875.93,Maysa Cardoso,3,1,3,7,Regular
8205,36,2,5190.68,Ryan da Luz,3,1,3,7,Regular
8206,26,1,2251.88,Maria Eduarda Freitas,3,1,1,5,Ocasional
8207,13,5,6024.96,Isabela Marques,4,3,3,10,VIP
8208,5,6,15991.51,Gustavo Cunha,4,3,4,11,VIP
8209,89,4,2553.06,Ana Viana,1,2,2,5,Ocasional
8210,7,5,9190.630000000001,Luísa Aparecida,4,3,4,11,VIP
8211,151,4,1904.9799999999998,Davi Lucas Oliveira,1,2,1,4,Ocasional
8212,179,2,2306.25,Mariah das Neves,1,1,2,4,Ocasional
8213,6,9,9287.51,Marcos Vinicius Teixeira,4,4,4,12,VIP
8214,33,3,2360.79,Valentim Brito,3,1,2,6,Ocasional
8215,11,3,4527.17,Ana Clara Rodrigues,4,1,3,8,Regular
8216,13,7,7317.2699999999995,Luiz Otávio Mendes,4,4,3,11,VIP
8217,155,4,6723.13,Antonella Guerra,1,2,3,6,Ocasional
8218,152,3,3655.28,Anthony da Costa,1,1,2,4,Ocasional
8219,5,3,3699.37,Heloísa Câmara,4,1,2,7,Regular
8220,88,4,7429.57,Srta. Ana Sophia Santos,1,2,4,7,Regular
8221,83,6,4838.01,Maria Luiza Moreira,2,3,3,8,Regular
8222,237,2,1659.47,Ian Câmara,1,1,1,3,Inativo
8223,15,3,7288.200000000001,Helena Oliveira,4,1,3,8,Regular
8224,38,3,3134.7400000000002,Samuel Fonseca,3,1,2,6,Ocasional
8225,1,4,15705.43,Nina Ribeiro,4,2,4,10,VIP
8226,15,3,2796.1899999999996,Miguel Rodrigues,4,1,2,7,Regular
8227,179,2,5218.84,Vinicius Albuquerque,1,1,3,5,Ocasional
8228,43,2,1379.62,Giovanna Costa,3,1,1,5,Ocasional
8229,7,7,6140.3,Lorena Aparecida,4,4,3,11,VIP
8230,8,3,6026.969999999999,Ana Cecília Jesus,4,1,3,8,Regular
8231,6,6,4577.74,Isaac Abreu,4,3,3,10,VIP
8232,32,5,6927.09,Benicio Costela,3,3,3,9,Regular
8233,86,4,6780.049999999999,João Vitor Câmara,2,2,3,7,Regular
8234,53,3,1260.77,Laís Jesus,2,1,1,4,Ocasional
8235,34,6,7094.6900000000005,Dr. Liam da Cruz,3,3,3,9,Regular
8236,37,8,8690.92,Dr. Juan Porto,3,4,4,11,VIP
8237,92,4,4381.92,Maria Helena Araújo,1,2,3,6,Ocasional
8238,69,3,3615.6600000000003,Alexia da Mata,2,1,2,5,Ocasional
8239,87,6,8823.27,Caroline da Cunha,2,3,4,9,Regular
8240,264,2,1375.72,Elisa Mendes,1,1,1,3,Inativo
8241,132,2,6129.67,Benjamim Rezende,1,1,3,5,Ocasional
8242,37,3,4598.07,Rebeca Moraes,3,1,3,7,Regular
8243,218,1,1118.32,Rafaela Novais,1,1,1,3,Inativo
8244,4,7,5821.01,Manuela Cunha,4,4,3,11,VIP
8245,20,4,5315.22,Maria Eduarda Ferreira,3,2,3,8,Regular
8246,17,4,7568.719999999999,Pedro Henrique Cassiano,4,2,4,10,VIP
8247,2,7,10066.01,Leandro Jesus,4,4,4,12,VIP
8248,60,6,2068.79,Sra. Manuela Dias,2,3,1,6,Ocasional
8249,156,6,10925.779999999999,Maria Cecília Porto,1,3,4,8,Regular
8250,51,5,4065.42,Thiago Duarte,2,3,2,7,Regular
8251,13,4,3821.99,Lorena Teixeira,4,2,2,8,Regular
8252,127,2,6687.04,Théo Sá,1,1,3,5,Ocasional
8253,65,4,3330.75,Cecília Novais,2,2,2,6,Ocasional
8254,26,4,1808.74,Aurora Vasconcelos,3,2,1,6,Ocasional
8255,156,2,419.29999999999995,Ana Júlia Oliveira,1,1,1,3,Inativo
8256,2,7,3999.69,Amanda Cavalcante,4,4,2,10,VIP
8257,4,4,16977.670000000002,João Lucas Dias,4,2,4,10,VIP
8258,28,5,4075.59,Arthur Gabriel da Conceição,3,3,2,8,Regular
8259,123,5,8829.75,Benjamim Fogaça,1,3,4,8,Regular
8260,133,6,2237.19,Cecília Costa,1,3,1,5,Ocasional
8261,170,8,6025.570000000001,Lucas Fernandes,1,4,3,8,Regular
8262,264,3,1903.24,Maria Eduarda Peixoto,1,1,1,3,Inativo
8263,8,6,16240.949999999999,Raul Peixoto,4,3,4,11,VIP
8264,26,5,5615.84,Sr. Francisco Vargas,3,3,3,9,Regular
8265,18,5,7777.01,Brayan da Mota,4,3,4,11,VIP
8266,15,4,1249.75,Cauê da Conceição,4,2,1,7,Regular
8267,154,3,2278.85,Caroline Moreira,1,1,2,4,Ocasional
8268,3,8,11895.09,Gael Correia,4,4,4,12,VIP
8269,8,7,1548.62,Dra. Natália Alves,4,4,1,9,Regular
8270,55,5,4331.21,Caio Siqueira,2,3,2,7,Regular
8271,159,3,4800.28,Cecília Monteiro,1,1,3,5,Ocasional
8272,21,3,1317.53,Augusto Pimenta,3,1,1,5,Ocasional
8273,58,3,3219.31,Luna Monteiro,2,1,2,5,Ocasional
8274,3,1,921.48,Brayan Gonçalves,4,1,1,6,Ocasional
8275,35,9,11610.15,Srta. Alexia Rocha,3,4,4,11,VIP
8276,67,8,15751.86,Isabela Nogueira,2,4,4,10,VIP
8277,16,3,8299.59,Cecilia Sales,4,1,4,9,Regular
8278,303,1,664.89,João Pedro Aparecida,1,1,1,3,Inativo
8279,13,6,2197.06,Lavínia Jesus,4,3,1,8,Regular
8280,54,3,3807.29,Léo Almeida,2,1,2,5,Ocasional
8281,142,3,5143.15,Lunna Jesus,1,1,3,5,Ocasional
8282,19,4,11905.99,Marina da Luz,4,2,4,10,VIP
8283,87,3,2096.63,Sr. Eduardo Nogueira,2,1,1,4,Ocasional
8284,17,4,6436.68,Thiago Ramos,4,2,3,9,Regular
8285,26,3,3433.8199999999997,Arthur Gabriel Garcia,3,1,2,6,Ocasional
8286,249,4,6724.22,Brayan Cassiano,1,2,3,6,Ocasional
8287,94,4,10580.369999999999,Vicente Cirino,1,2,4,7,Regular
8288,5,3,6389.0,Alana Rezende,4,1,3,8,Regular
8289,15,3,6064.35,Cecília Cavalcanti,4,1,3,8,Regular
8290,58,5,2866.1,Rafaela Sales,2,3,2,7,Regular
8291,195,3,1286.0,Dr. João Gabriel Marques,1,1,1,3,Inativo
8292,3,4,2479.75,Maria Cecília Sampaio,4,2,2,8,Regular
8293,36,7,6403.570000000001,Léo Pires,3,4,3,10,VIP
8294,38,3,6242.25,Mathias Brito,3,1,3,7,Regular
8295,207,3,4872.68,Emilly Marques,1,1,3,5,Ocasional
8296,191,2,7085.13,Davi Lucca Sales,1,1,3,5,Ocasional
8297,107,2,2734.27,Dr. Emanuel Oliveira,1,1,2,4,Ocasional
8298,4,5,5057.58,Marina Mendes,4,3,3,10,VIP
8299,43,3,3686.79,Luiz Gustavo Abreu,3,1,2,6,Ocasional
8300,6,7,12978.84,Laura Aparecida,4,4,4,12,VIP
8301,366,1,76.98,Ayla Cirino,1,1,1,3,Inativo
8302,52,3,3596.6499999999996,Marina Montenegro,2,1,2,5,Ocasional
8303,97,4,1105.8799999999999,Pedro Cirino,1,2,1,4,Ocasional
8304,79,3,2672.41,Dr. Arthur Garcia,2,1,2,5,Ocasional
8305,3,9,11269.710000000001,Sr. Gabriel Cunha,4,4,4,12,VIP
8306,29,4,4590.7699999999995,Sra. Ana Carvalho,3,2,3,8,Regular
8307,13,10,12526.720000000001,Gabriel Barros,4,4,4,12,VIP
8308,80,3,4001.2999999999997,Marcela Silva,2,1,2,5,Ocasional
8309,39,4,3667.8500000000004,Ágatha das Neves,3,2,2,7,Regular
8310,2,5,10275.17,Marcelo Borges,4,3,4,11,VIP
8311,188,4,2265.5200000000004,José Marques,1,2,2,5,Ocasional
8312,60,7,10584.92,Marcos Vinicius Brito,2,4,4,10,VIP
8313,149,6,16381.32,Luigi Correia,1,3,4,8,Regular
8314,19,4,6353.05,Matheus Cavalcante,4,2,3,9,Regular
8315,62,3,886.13,Luara Fonseca,2,1,1,4,Ocasional
8316,179,3,1181.47,Josué Jesus,1,1,1,3,Inativo
8317,8,6,4470.66,Lucas Martins,4,3,3,10,VIP
8318,115,2,3501.36,Sr. José Pedro Jesus,1,1,2,4,Ocasional
8319,7,7,12303.13,João Guilherme Vieira,4,4,4,12,VIP
8320,27,3,3328.68,Ana Julia Jesus,3,1,2,6,Ocasional
8321,34,3,9475.1,Stella Marques,3,1,4,8,Regular
8322,92,4,1854.34,João Miguel Lima,1,2,1,4,Ocasional
8323,65,7,14798.34,Arthur Miguel Lopes,2,4,4,10,VIP
8324,63,5,6402.95,Matheus Câmara,2,3,3,8,Regular
8325,292,1,500.39,Pedro Henrique Rocha,1,1,1,3,Inativo
8326,54,5,3673.8199999999997,Anthony Gabriel Novaes,2,3,2,7,Regular
8327,159,2,1446.25,Maria Fernanda Guerra,1,1,1,3,Inativo
8328,10,7,8839.53,Sr. Enrico Machado,4,4,4,12,VIP
8329,36,6,11419.94,Sra. Cecília Rios,3,3,4,10,VIP
8330,53,4,1436.19,Benício da Mota,2,2,1,5,Ocasional
8331,78,5,4458.54,Hellena Ramos,2,3,3,8,Regular
8332,116,5,4312.46,José Pedro da Mata,1,3,2,6,Ocasional
8333,121,4,2577.0,Gael Henrique Sales,1,2,2,5,Ocasional
8334,87,4,3866.7200000000003,Sra. Esther da Mata,2,2,2,6,Ocasional
8335,22,4,1814.3600000000001,Diogo Sousa,3,2,1,6,Ocasional
8336,31,3,7449.17,Matteo Jesus,3,1,4,8,Regular
8337,88,5,3839.95,Thomas Mendes,1,3,2,6,Ocasional
8338,29,2,4979.530000000001,Sarah Rodrigues,3,1,3,7,Regular
8339,9,6,4319.4,Sr. João Moreira,4,3,2,9,Regular
8340,67,3,3182.34,Apollo da Cunha,2,1,2,5,Ocasional
8341,18,5,11273.95,Olivia Costa,4,3,4,11,VIP
8342,4,4,8865.439999999999,Srta. Sophie Vasconcelos,4,2,4,10,VIP
8343,37,2,3197.93,Yuri Lopes,3,1,2,6,Ocasional
8345,54,6,6901.54,Luiz Fernando Melo,2,3,3,8,Regular
8346,18,1,3792.66,Dra. Maria Helena Duarte,4,1,2,7,Regular
8347,131,2,2244.72,Maria Liz Pacheco,1,1,1,3,Inativo
8348,122,2,3395.8,Gabriela Almeida,1,1,2,4,Ocasional
8349,74,5,7637.93,Natália Martins,2,3,4,9,Regular
8350,321,1,672.05,Enzo Gabriel Machado,1,1,1,3,Inativo
8351,2,8,11141.560000000001,Davi Luiz Duarte,4,4,4,12,VIP
8352,34,4,674.11,Ana Julia Cirino,3,2,1,6,Ocasional
8353,287,1,1014.01,Natália Sousa,1,1,1,3,Inativo
8354,165,5,9240.58,Luiz Fernando Andrade,1,3,4,8,Regular
8355,264,3,6036.929999999999,Emanuella Caldeira,1,1,3,5,Ocasional
8356,112,4,1133.14,Vinicius Gonçalves,1,2,1,4,Ocasional
8357,69,5,4352.5,Davi Lucas Novais,2,3,2,7,Regular
8358,112,4,5431.9,Sr. Ravy Sá,1,2,3,6,Ocasional
8359,9,7,11118.7,Sr. Enzo Gabriel Pastor,4,4,4,12,VIP
8360,41,9,13499.1,Ayla Gomes,3,4,4,11,VIP
8361,47,4,1902.4699999999998,Calebe Almeida,2,2,1,5,Ocasional
8362,30,3,6966.07,Srta. Cecília Macedo,3,1,3,7,Regular
8363,76,4,10123.42,Leandro Teixeira,2,2,4,8,Regular
8364,9,4,9225.64,Melina Rodrigues,4,2,4,10,VIP
8365,26,6,12040.41,Dra. Maria Liz Machado,3,3,4,10,VIP
8366,41,5,23224.08,Aylla Mendonça,3,3,4,10,VIP
8367,81,4,3789.6400000000003,Joana Camargo,2,2,2,6,Ocasional
8368,19,2,5448.7699999999995,Vinicius Moura,4,1,3,8,Regular
8369,112,2,1507.39,João Gabriel Gomes,1,1,1,3,Inativo
8370,223,1,1115.29,Bryan Castro,1,1,1,3,Inativo
8371,156,6,4878.35,Vitor Gabriel Borges,1,3,3,7,Regular
8372,220,3,4328.61,Luan Sales,1,1,2,4,Ocasional
8373,4,7,10524.21,Maitê Sampaio,4,4,4,12,VIP
8374,74,2,3018.83,Dante Sampaio,2,1,2,5,Ocasional
8375,265,4,2009.33,Nicolas Melo,1,2,1,4,Ocasional
8376,22,3,3412.22,Bella Cunha,3,1,2,6,Ocasional
8377,56,3,4767.69,João Guilherme Costa,2,1,3,6,Ocasional
8378,126,3,5903.36,Sr. Guilherme Siqueira,1,1,3,5,Ocasional
8379,38,9,15773.369999999999,Melina Correia,3,4,4,11,VIP
8380,44,4,5677.1,Alexia Nascimento,2,2,3,7,Regular
8381,185,3,2880.05,Sra. Milena Vargas,1,1,2,4,Ocasional
8382,310,1,728.76,Dr. Théo da Luz,1,1,1,3,Inativo
8383,29,6,3868.32,Srta. Esther Rodrigues,3,3,2,8,Regular
8384,22,5,4359.43,Davi Lucca da Mota,3,3,2,8,Regular
8385,46,3,1705.73,Henry Barros,2,1,1,4,Ocasional
8386,139,3,8200.66,Ryan Porto,1,1,4,6,Ocasional
8387,41,1,767.8,Thomas Cavalcanti,3,1,1,5,Ocasional
8388,38,5,6408.37,Caio Câmara,3,3,3,9,Regular
8389,87,5,3973.8100000000004,Yasmin Jesus,2,3,2,7,Regular
8390,43,2,2603.26,Luana Sampaio,3,1,2,6,Ocasional
8391,64,7,15917.180000000002,Oliver Gonçalves,2,4,4,10,VIP
8392,56,3,2265.33,Pedro Montenegro,2,1,2,5,Ocasional
8393,17,9,13471.65,Cauê Fernandes,4,4,4,12,VIP
8394,3,5,841.0899999999999,Sophie Fonseca,4,3,1,8,Regular
8395,12,6,3927.7099999999996,José Almeida,4,3,2,9,Regular
8396,108,2,1274.01,Daniela Rios,1,1,1,3,Inativo
8397,61,4,4062.0,Manuela Oliveira,2,2,2,6,Ocasional
8398,35,9,8294.92,Ravy Moraes,3,4,4,11,VIP
8399,144,3,1653.65,Hadassa Lopes,1,1,1,3,Inativo
8400,58,4,3414.6099999999997,Antony Barros,2,2,2,6,Ocasional
8401,141,2,9378.91,Isabelly Garcia,1,1,4,6,Ocasional
8402,26,6,5854.4,Fernanda Cirino,3,3,3,9,Regular
8403,11,4,1102.95,Srta. Caroline Vasconcelos,4,2,1,7,Regular
8404,215,4,1294.23,Vitória Carvalho,1,2,1,4,Ocasional
8405,83,5,10485.56,Emanuel da Conceição,2,3,4,9,Regular
8406,13,2,467.85,Maria Júlia Moreira,4,1,1,6,Ocasional
8407,57,5,7851.67,Mariah Fogaça,2,3,4,9,Regular
8408,58,2,1638.9099999999999,Otto Dias,2,1,1,4,Ocasional
8409,123,4,7439.389999999999,Luiz Fernando Carvalho,1,2,4,7,Regular
8410,2,6,5429.56,Srta. Clara Peixoto,4,3,3,10,VIP
8411,47,3,1258.19,Sra. Letícia Mendonça,2,1,1,4,Ocasional
8412,12,4,8990.35,Clarice Cavalcante,4,2,4,10,VIP
8413,12,4,5029.179999999999,Theo Guerra,4,2,3,9,Regular
8414,10,11,17913.969999999998,Sr. Matheus Gonçalves,4,4,4,12,VIP
8415,45,3,4777.38,Daniela Montenegro,2,1,3,6,Ocasional
8416,64,3,4939.02,Fernanda Silveira,2,1,3,6,Ocasional
8417,159,2,2056.08,Antony da Mota,1,1,1,3,Inativo
8418,30,2,1267.01,Dra. Ana Vitória Barros,3,1,1,5,Ocasional
8419,270,2,351.09000000000003,Dra. Maria Cecília Cavalcante,1,1,1,3,Inativo
8420,163,4,6752.3,José Mendes,1,2,3,6,Ocasional
8421,27,6,6557.76,Heloisa Porto,3,3,3,9,Regular
8422,22,2,8453.33,Maya Cassiano,3,1,4,8,Regular
8423,79,3,3767.1,Ana Clara Barbosa,2,1,2,5,Ocasional
8424,264,3,2473.68,Pedro Henrique Guerra,1,1,2,4,Ocasional
8425,81,2,1617.3500000000001,Laura Moraes,2,1,1,4,Ocasional
8426,12,6,4102.07,Mariah da Cruz,4,3,2,9,Regular
8427,198,4,6550.01,Clarice da Conceição,1,2,3,6,Ocasional
8428,109,2,978.94,Isabela Costela,1,1,1,3,Inativo
8429,4,7,8350.95,Dr. Liam Novais,4,4,4,12,VIP
8430,76,2,2148.5499999999997,Mathias Rezende,2,1,1,4,Ocasional
8431,108,2,1213.96,Gael Nascimento,1,1,1,3,Inativo
8432,9,5,3227.5899999999997,Dr. Otto Aragão,4,3,2,9,Regular
8433,6,8,4738.45,Lucca Vasconcelos,4,4,3,11,VIP
8434,135,2,7993.51,Manuella Camargo,1,1,4,6,Ocasional
8435,238,1,1637.18,Maria Clara Guerra,1,1,1,3,Inativo
8436,14,7,14802.66,Carolina Sousa,4,4,4,12,VIP
8437,56,5,11832.24,Sr. Matheus Aparecida,2,3,4,9,Regular
8438,51,7,6958.76,Yago Campos,2,4,3,9,Regular
8439,134,2,2631.1,Isadora da Cunha,1,1,2,4,Ocasional
8440,1,5,5132.97,Diego Cavalcante,4,3,3,10,VIP
8441,57,4,2468.9300000000003,Antonella Machado,2,2,2,6,Ocasional
8442,25,3,4533.070000000001,Ágatha Peixoto,3,1,3,7,Regular
8443,70,3,3725.76,Olívia Andrade,2,1,2,5,Ocasional
8444,35,4,8522.27,Maria Helena Casa Grande,3,2,4,9,Regular
8445,27,6,6762.4,João Felipe Teixeira,3,3,3,9,Regular
8446,102,2,121.52,Maria Alice Nunes,1,1,1,3,Inativo
8447,6,7,4711.62,Rafael Nunes,4,4,3,11,VIP
8448,76,8,11298.609999999999,Ana Vitória Jesus,2,4,4,10,VIP
8449,41,4,2065.4900000000002,Davi Luiz Oliveira,3,2,1,6,Ocasional
8450,11,5,11183.87,Leandro Moreira,4,3,4,11,VIP
8451,17,6,7573.25,Maria Júlia Azevedo,4,3,4,11,VIP
8452,286,1,3302.73,Helena Melo,1,1,2,4,Ocasional
8453,45,5,7502.01,Daniela Farias,2,3,4,9,Regular
8454,25,7,15977.83,Dra. Daniela Moura,3,4,4,11,VIP
8455,58,2,8082.96,Léo Nunes,2,1,4,7,Regular
8456,28,10,16212.64,Kamilly Mendonça,3,4,4,11,VIP
8457,70,9,8632.19,João Novaes,2,4,4,10,VIP
8458,2,6,9112.210000000001,Heloísa Câmara,4,3,4,11,VIP
8459,13,6,5737.91,Matteo Peixoto,4,3,3,10,VIP
8460,35,6,7780.48,Aurora Pereira,3,3,4,10,VIP
8461,54,2,2662.77,Yuri Pereira,2,1,2,5,Ocasional
8462,50,1,4224.72,Srta. Sofia Castro,2,1,2,5,Ocasional
8463,45,8,6127.19,Davi Lucas Sousa,2,4,3,9,Regular
8464,12,2,4388.34,Bento Barbosa,4,1,3,8,Regular
8465,24,7,5133.3,Dra. Alice Pacheco,3,4,3,10,VIP
8466,190,3,4586.05,Nathan Barbosa,1,1,3,5,Ocasional
8467,50,4,2291.99,Gabrielly Pimenta,2,2,2,6,Ocasional
8468,28,6,12962.71,Leandro Guerra,3,3,4,10,VIP
8469,15,5,1827.75,Anna Liz Camargo,4,3,1,8,Regular
8470,43,4,4256.12,Helena Sousa,3,2,2,7,Regular
8471,23,3,2137.77,Sr. José Pedro Marques,3,1,1,5,Ocasional
8472,3,7,8871.86,Agatha Siqueira,4,4,4,12,VIP
8473,124,3,737.65,Bruna Pires,1,1,1,3,Inativo
8474,110,1,993.98,Maya Pacheco,1,1,1,3,Inativo
8475,25,8,5019.24,Isaque Teixeira,3,4,3,10,VIP
8476,33,4,8109.73,Sra. Mirella Abreu,3,2,4,9,Regular
8477,30,6,10449.15,Leandro Marques,3,3,4,10,VIP
8478,32,4,2119.32,Gael Henrique Brito,3,2,1,6,Ocasional
8479,56,6,5867.9400000000005,Oliver Dias,2,3,3,8,Regular
8480,11,7,7463.96,Luiza Novais,4,4,4,12,VIP
8481,133,2,1081.57,Brenda Moreira,1,1,1,3,Inativo
8482,78,4,2722.82,Yan Albuquerque,2,2,2,6,Ocasional
8483,25,6,4929.1900000000005,Yago Cavalcante,3,3,3,9,Regular
8484,86,3,1506.3899999999999,Calebe Borges,2,1,1,4,Ocasional
8485,24,7,4981.49,Maria Helena Guerra,3,4,3,10,VIP
8486,1,5,511.09,Antonella das Neves,4,3,1,8,Regular
8487,45,4,5151.8099999999995,Pedro Henrique Abreu,2,2,3,7,Regular
8488,173,5,9418.84,Luiz Miguel da Cunha,1,3,4,8,Regular
8489,35,4,2781.0099999999998,Dr. Enzo Gabriel Viana,3,2,2,7,Regular
8490,187,3,4766.56,Isabella Rocha,1,1,3,5,Ocasional
8491,35,5,4419.13,Sra. Ana Liz Vasconcelos,3,3,3,9,Regular
8492,328,2,2686.6099999999997,Isadora Duarte,1,1,2,4,Ocasional
8493,27,7,14002.97,Bruna da Costa,3,4,4,11,VIP
8494,28,3,1440.75,Enzo Macedo,3,1,1,5,Ocasional
8495,27,4,2239.45,Bernardo Teixeira,3,2,1,6,Ocasional
8496,158,1,800.46,Gael Henrique Costa,1,1,1,3,Inativo
8497,12,6,4787.61,Lara Aparecida,4,3,3,10,VIP
8498,57,4,6413.719999999999,Bruna Pinto,2,2,3,7,Regular
8499,170,3,7659.780000000001,Dra. Zoe Carvalho,1,1,4,6,Ocasional
8500,60,2,4155.9400000000005,Lívia Viana,2,1,2,5,Ocasional
8501,8,7,9243.77,Asafe Castro,4,4,4,12,VIP
8502,50,9,7453.98,Bruno Guerra,2,4,4,10,VIP
8503,44,2,1409.84,Kamilly Vargas,2,1,1,4,Ocasional
8504,121,3,3398.1,Sr. Leonardo da Rosa,1,1,2,4,Ocasional
8505,64,4,1940.2599999999998,Lívia Jesus,2,2,1,5,Ocasional
8506,283,1,1175.99,Lorena das Neves,1,1,1,3,Inativo
8507,1,2,1351.3600000000001,Maria Flor Azevedo,4,1,1,6,Ocasional
8508,3,5,8640.16,Fernanda Rodrigues,4,3,4,11,VIP
8509,19,5,2161.84,Gael Cirino,4,3,1,8,Regular
8510,67,1,1196.14,Maria Clara Moraes,2,1,1,4,Ocasional
8511,127,8,6895.3,Gabriel Jesus,1,4,3,8,Regular
8512,26,4,1430.24,Ana Clara Pinto,3,2,1,6,Ocasional
8513,65,5,9626.89,Augusto Farias,2,3,4,9,Regular
8514,140,2,2687.0499999999997,Otto Gomes,1,1,2,4,Ocasional
8515,12,8,7952.1,Juan Correia,4,4,4,12,VIP
8516,79,8,13371.369999999999,Liam da Cruz,2,4,4,10,VIP
8517,57,5,5049.22,Rodrigo Barros,2,3,3,8,Regular
8518,128,1,93.47,Ana Carolina da Luz,1,1,1,3,Inativo
8519,74,4,1164.97,Dr. Kaique Rios,2,2,1,5,Ocasional
8520,67,3,5815.360000000001,Luigi Cunha,2,1,3,6,Ocasional
8521,258,2,1483.19,Davi Lucca da Paz,1,1,1,3,Inativo
8522,60,2,6083.7,Isabela Souza,2,1,3,6,Ocasional
8523,62,3,3151.91,Yan Cardoso,2,1,2,5,Ocasional
8524,73,6,6707.76,Dr. Luiz Henrique Leão,2,3,3,8,Regular
8525,157,6,8052.52,Fernando Duarte,1,3,4,8,Regular
8526,77,7,6356.59,Srta. Sara Pires,2,4,3,9,Regular
8527,50,1,1284.64,Rafaela Costela,2,1,1,4,Ocasional
8528,237,2,5514.150000000001,Stella Viana,1,1,3,5,Ocasional
8529,6,6,8890.36,Breno da Cunha,4,3,4,11,VIP
8530,6,7,8886.48,Milena Casa Grande,4,4,4,12,VIP
8531,3,8,7461.39,Davi Machado,4,4,4,12,VIP
8532,31,13,8360.0,Hellena Lopes,3,4,4,11,VIP
8533,173,1,1711.63,Raul Siqueira,1,1,1,3,Inativo
8534,205,2,2514.55,Olívia das Neves,1,1,2,4,Ocasional
8535,44,4,3524.07,Arthur Câmara,2,2,2,6,Ocasional
8536,33,7,12430.8,Ana Julia Ferreira,3,4,4,11,VIP
8537,47,4,6944.61,João Pedro Leão,2,2,3,7,Regular
8538,80,4,3152.59,Maria Laura Fernandes,2,2,2,6,Ocasional
8539,282,1,408.5,Maitê da Rocha,1,1,1,3,Inativo
8540,68,2,842.3399999999999,Sr. Matteo Ribeiro,2,1,1,4,Ocasional
8541,47,3,10186.24,Vitor Hugo Santos,2,1,4,7,Regular
8542,43,6,4812.74,Julia Cardoso,3,3,3,9,Regular
8543,35,3,1051.37,Yago Ferreira,3,1,1,5,Ocasional
8544,270,1,102.24,Isaque da Mota,1,1,1,3,Inativo
8545,73,4,2419.05,Isabel Novaes,2,2,2,6,Ocasional
8546,34,1,332.13,Lorena Castro,3,1,1,5,Ocasional
8547,184,2,2264.56,Maria Vitória Cassiano,1,1,2,4,Ocasional
8548,119,2,3431.3599999999997,Lorenzo Fonseca,1,1,2,4,Ocasional
8549,43,5,3034.15,Maria Sophia Pires,3,3,2,8,Regular
8550,3,7,21531.829999999998,Ana Lívia Moreira,4,4,4,12,VIP
8551,39,6,16375.63,Luiz Miguel Gonçalves,3,3,4,10,VIP
8552,39,7,9046.02,João Pimenta,3,4,4,11,VIP
8553,10,8,6807.76,Aylla Rios,4,4,3,11,VIP
8554,111,7,7191.68,Caio da Conceição,1,4,3,8,Regular
8556,12,5,9920.18,Emanuelly Araújo,4,3,4,11,VIP
8557,38,4,582.74,Maya Rezende,3,2,1,6,Ocasional
8558,27,6,5380.74,Sra. Lunna Campos,3,3,3,9,Regular
8559,8,5,3400.89,Manuella Pereira,4,3,2,9,Regular
8560,231,3,4230.08,Marina Pacheco,1,1,2,4,Ocasional
8561,51,4,4592.04,Dr. Dante Barros,2,2,3,7,Regular
8562,2,4,2615.7400000000002,Melissa Souza,4,2,2,8,Regular
8563,2,6,5360.27,Sra. Marina Ramos,4,3,3,10,VIP
8564,17,6,6861.120000000001,Dr. Henry Gabriel Siqueira,4,3,3,10,VIP
8565,4,4,6237.5599999999995,Gustavo Henrique Siqueira,4,2,3,9,Regular
8566,252,2,661.83,Diogo Araújo,1,1,1,3,Inativo
8567,15,5,7325.290000000001,Théo Azevedo,4,3,4,11,VIP
8568,6,3,4021.77,Caleb Gonçalves,4,1,2,7,Regular
8569,163,5,10557.29,Vicente Duarte,1,3,4,8,Regular
8570,31,5,3319.49,Dra. Aurora Rodrigues,3,3,2,8,Regular
8571,25,4,2787.21,Francisco Azevedo,3,2,2,7,Regular
8572,47,7,3156.54,Srta. Mariane Silveira,2,4,2,8,Regular
8573,8,2,507.83000000000004,Davi Lucca Albuquerque,4,1,1,6,Ocasional
8574,27,8,9382.26,Sra. Bella da Mata,3,4,4,11,VIP
8575,48,7,7904.9,Sr. Calebe Pastor,2,4,4,10,VIP
8576,4,9,14531.93,Kaique Cirino,4,4,4,12,VIP
8577,57,3,850.3100000000001,Dr. João Felipe Costa,2,1,1,4,Ocasional
8578,87,2,2273.67,Dra. Ana Laura Vargas,2,1,2,5,Ocasional
8579,14,5,11928.16,André Lopes,4,3,4,11,VIP
8580,58,2,510.94999999999993,Srta. Isis Fonseca,2,1,1,4,Ocasional
8581,28,6,5663.25,Diego Nascimento,3,3,3,9,Regular
8582,80,4,13592.73,Arthur Gabriel da Rocha,2,2,4,8,Regular
8583,132,4,3516.6099999999997,Nathan Abreu,1,2,2,5,Ocasional
8585,36,5,9642.48,Pedro Henrique Lima,3,3,4,10,VIP
8586,53,4,6791.57,Stephany Peixoto,2,2,3,7,Regular
8587,63,1,643.06,Dr. Samuel Rocha,2,1,1,4,Ocasional
8588,188,4,2122.74,Maria Laura Cavalcante,1,2,1,4,Ocasional
8589,71,2,1435.03,Srta. Clara Dias,2,1,1,4,Ocasional
8590,46,5,7283.219999999999,Isabella Duarte,2,3,3,8,Regular
8591,186,2,189.14,Yan Viana,1,1,1,3,Inativo
8592,28,3,3923.13,Anna Liz da Rosa,3,1,2,6,Ocasional
8593,32,4,2180.74,Rafaela Santos,3,2,1,6,Ocasional
8594,8,10,6720.25,Ana Beatriz Ramos,4,4,3,11,VIP
8595,159,5,6327.01,Enrico Fonseca,1,3,3,7,Regular
8596,25,5,8622.47,Yan Pastor,3,3,4,10,VIP
8597,88,5,6314.52,Rafaela Sales,1,3,3,7,Regular
8598,28,6,11037.63,Maysa Santos,3,3,4,10,VIP
8599,119,2,304.3,Thomas Jesus,1,1,1,3,Inativo
8600,1,9,16535.93,Sra. Eloah Ferreira,4,4,4,12,VIP
8601,53,3,9769.77,Rodrigo Araújo,2,1,4,7,Regular
8602,18,2,6621.95,Júlia Azevedo,4,1,3,8,Regular
8603,20,4,5684.38,Diego Leão,3,2,3,8,Regular
8604,237,4,3239.64,Sra. Bianca Nogueira,1,2,2,5,Ocasional
8605,106,6,2686.3,Anna Liz Caldeira,1,3,2,6,Ocasional
8606,58,8,5847.1,Milena Vargas,2,4,3,9,Regular
8607,13,8,16219.85,Cecilia Duarte,4,4,4,12,VIP
8608,64,3,4721.58,Nina Mendonça,2,1,3,6,Ocasional
8609,60,4,1808.23,Stella Sales,2,2,1,5,Ocasional
8610,109,5,13384.16,Larissa Araújo,1,3,4,8,Regular
8611,43,4,4846.5,Vitor Gabriel Gonçalves,3,2,3,8,Regular
8612,35,6,5002.889999999999,Benjamim Pinto,3,3,3,9,Regular
8613,39,6,7518.46,Bárbara Cardoso,3,3,4,10,VIP
8614,113,4,4761.59,Rebeca Sales,1,2,3,6,Ocasional
8615,27,4,2326.14,Eduardo da Cunha,3,2,2,7,Regular
8616,37,7,11651.62,Ana Julia Souza,3,4,4,11,VIP
8617,15,7,4497.8,João Lucas Pires,4,4,3,11,VIP
8618,14,2,3963.14,Dr. Vitor Fernandes,4,1,2,7,Regular
8619,25,6,2061.54,Henry Rios,3,3,1,7,Regular
8620,95,6,7941.66,Isadora Cavalcanti,1,3,4,8,Regular
8621,34,8,10898.23,Luan Ribeiro,3,4,4,11,VIP
8622,76,7,4985.69,Mariane da Rosa,2,4,3,9,Regular
8623,28,2,1157.21,Sra. Marcela Costela,3,1,1,5,Ocasional
8624,27,2,2051.4900000000002,Diego Mendonça,3,1,1,5,Ocasional
8625,78,5,5721.34,Ana Liz Cassiano,2,3,3,8,Regular
8626,89,5,13985.03,Ana Carolina Cirino,1,3,4,8,Regular
8627,45,3,4290.64,Dra. Cecilia Costela,2,1,2,5,Ocasional
8628,22,4,4508.29,Maysa Duarte,3,2,3,8,Regular
8629,11,3,9805.05,Mariana Almeida,4,1,4,9,Regular
8630,49,3,2087.2799999999997,Valentim Garcia,2,1,1,4,Ocasional
8631,38,2,3075.58,Antony Ferreira,3,1,2,6,Ocasional
8632,1,2,2129.2,Cecília Cavalcante,4,1,1,6,Ocasional
8633,6,5,3959.63,Isis Aparecida,4,3,2,9,Regular
8634,160,3,6196.43,Gabriela Moreira,1,1,3,5,Ocasional
8635,44,3,2068.45,Dr. Thiago Aragão,2,1,1,4,Ocasional
8636,91,6,7470.72,Gustavo Rocha,1,3,4,8,Regular
8637,18,5,1472.4,Vinicius Rios,4,3,1,8,Regular
8638,22,5,6987.36,Dr. Ian da Paz,3,3,3,9,Regular
8639,215,4,9420.21,Luan Fonseca,1,2,4,7,Regular
8640,130,4,1221.61,Clarice Sá,1,2,1,4,Ocasional
8641,6,3,11385.560000000001,Guilherme Fogaça,4,1,4,9,Regular
8642,27,2,936.1,Pedro Correia,3,1,1,5,Ocasional
8643,1,5,10020.92,Maria Julia Ferreira,4,3,4,11,VIP
8644,40,2,2462.9,Ana Cecília Albuquerque,3,1,2,6,Ocasional
8645,189,1,709.37,Emilly da Rosa,1,1,1,3,Inativo
8646,46,6,15241.369999999999,Juan Martins,2,3,4,9,Regular
8647,16,7,9761.86,Eduarda Moraes,4,4,4,12,VIP
8648,3,8,11032.130000000001,Ana Cardoso,4,4,4,12,VIP
8649,32,4,1873.56,Isabel Nunes,3,2,1,6,Ocasional
8650,226,1,95.3,João Lucas Castro,1,1,1,3,Inativo
8651,1,5,7217.31,Luana da Rosa,4,3,3,10,VIP
8652,331,1,55.23,Ana Beatriz Guerra,1,1,1,3,Inativo
8653,17,6,2658.58,Benjamim Gomes,4,3,2,9,Regular
8654,29,10,10901.94,Dra. Bella Guerra,3,4,4,11,VIP
8655,84,4,2459.81,Arthur Miguel Moreira,2,2,2,6,Ocasional
8656,116,3,3085.6099999999997,Lavínia Fernandes,1,1,2,4,Ocasional
8657,127,5,4779.77,Ana Vitória Silva,1,3,3,7,Regular
8658,98,1,2592.36,Enrico Ramos,1,1,2,4,Ocasional
8659,102,3,1383.3,Elisa Lopes,1,1,1,3,Inativo
8660,16,8,8911.36,Eloah Marques,4,4,4,12,VIP
8661,35,6,6598.4800000000005,Nicolas Dias,3,3,3,9,Regular
8662,39,2,1558.3200000000002,Rael Lopes,3,1,1,5,Ocasional
8663,29,3,3314.96,Ísis Melo,3,1,2,6,Ocasional
8664,66,5,3867.47,Renan Aparecida,2,3,2,7,Regular
8665,46,4,1454.53,Nicole Cassiano,2,2,1,5,Ocasional
8666,117,6,8988.44,Maria Luiza da Rocha,1,3,4,8,Regular
8667,34,4,4247.65,Maria Sophia Andrade,3,2,2,7,Regular
8668,26,7,8922.36,Antonella Rezende,3,4,4,11,VIP
8669,37,6,10339.51,Gustavo Henrique Santos,3,3,4,10,VIP
8670,17,6,8289.51,Yago Castro,4,3,4,11,VIP
8671,73,8,13557.41,Sophia Teixeira,2,4,4,10,VIP
8672,32,4,2891.73,Lucca Barbosa,3,2,2,7,Regular
8673,150,6,6365.09,Sophie Lima,1,3,3,7,Regular
8674,3,8,7566.64,Stella Pimenta,4,4,4,12,VIP
8675,10,5,4120.92,Ian Pacheco,4,3,2,9,Regular
8676,65,2,2368.82,Hadassa Farias,2,1,2,5,Ocasional
8677,53,4,7350.39,Lorenzo Pimenta,2,2,4,8,Regular
8678,8,6,8211.46,Benicio Nascimento,4,3,4,11,VIP
8679,54,2,6069.67,Carlos Eduardo Jesus,2,1,3,6,Ocasional
8680,203,4,6789.24,Murilo Fonseca,1,2,3,6,Ocasional
8681,4,8,11268.0,Eduardo Moreira,4,4,4,12,VIP
8682,66,4,6596.089999999999,Sr. Kaique Machado,2,2,3,7,Regular
8683,4,6,8495.19,Valentim Freitas,4,3,4,11,VIP
8684,29,5,3392.2999999999997,Lucas da Mata,3,3,2,8,Regular
8685,55,3,1351.5900000000001,Raquel da Luz,2,1,1,4,Ocasional
8686,176,2,2314.87,Isadora Azevedo,1,1,2,4,Ocasional
8687,39,4,3707.31,Sr. Valentim Cirino,3,2,2,7,Regular
8688,22,4,2646.77,Dr. Luiz Felipe Mendes,3,2,2,7,Regular
8689,198,1,1629.14,Mirella Moura,1,1,1,3,Inativo
8690,13,3,1495.52,Melissa da Costa,4,1,1,6,Ocasional
8691,43,6,4959.18,Laís Duarte,3,3,3,9,Regular
8692,25,7,2723.7,Henrique Pacheco,3,4,2,9,Regular
8693,17,6,5111.070000000001,Ravi Lucca Porto,4,3,3,10,VIP
8694,50,5,10767.84,Srta. Maysa das Neves,2,3,4,9,Regular
8695,43,10,11825.48,Beatriz Rodrigues,3,4,4,11,VIP
8696,9,2,1074.85,Sr. Murilo da Mata,4,1,1,6,Ocasional
8697,80,3,1832.04,Eduarda Barros,2,1,1,4,Ocasional
8698,11,10,8764.5,Sra. Bárbara da Conceição,4,4,4,12,VIP
8699,16,9,11953.06,Heloísa Abreu,4,4,4,12,VIP
8700,12,4,4587.82,Luiz Henrique Borges,4,2,3,9,Regular
8701,13,8,12483.470000000001,Nicole Caldeira,4,4,4,12,VIP
8702,54,3,3539.84,Dante Moreira,2,1,2,5,Ocasional
8703,23,4,1926.35,Gabriela Peixoto,3,2,1,6,Ocasional
8704,31,4,5419.530000000001,Maria Vasconcelos,3,2,3,8,Regular
8705,30,5,8289.15,Mateus Farias,3,3,4,10,VIP
8706,41,4,6386.1,Ana Lívia Fonseca,3,2,3,8,Regular
8707,261,1,79.04,Alana Nascimento,1,1,1,3,Inativo
8708,68,1,759.52,Marcelo Dias,2,1,1,4,Ocasional
8709,23,3,7838.76,Srta. Catarina Azevedo,3,1,4,8,Regular
8710,12,7,17588.04,Maria Helena Pinto,4,4,4,12,VIP
8711,38,3,5251.96,Caio Cunha,3,1,3,7,Regular
8712,250,3,3499.3199999999997,Olivia da Luz,1,1,2,4,Ocasional
8713,1,4,8232.9,Maysa Campos,4,2,4,10,VIP
8714,71,2,1031.53,Mariane Siqueira,2,1,1,4,Ocasional
8715,9,5,2705.67,Fernanda Moraes,4,3,2,9,Regular
8716,33,2,3103.0,Davi Marques,3,1,2,6,Ocasional
8717,154,3,2827.06,Josué Azevedo,1,1,2,4,Ocasional
8718,130,2,1365.26,Pedro Lucas Oliveira,1,1,1,3,Inativo
8719,167,3,1817.74,Maria Fernanda Campos,1,1,1,3,Inativo
8720,316,1,782.21,João Miguel Nunes,1,1,1,3,Inativo
8721,60,7,8186.68,Bianca das Neves,2,4,4,10,VIP
8722,68,6,7214.04,Emilly Machado,2,3,3,8,Regular
8723,93,4,2757.43,Maria Araújo,1,2,2,5,Ocasional
8724,55,5,4354.710000000001,Ana Carolina Novaes,2,3,2,7,Regular
8725,78,4,8071.049999999999,Pedro Miguel Macedo,2,2,4,8,Regular
8726,14,5,1843.36,Sra. Ana Liz Nunes,4,3,1,8,Regular
8727,57,3,1846.45,Maria Sophia Cassiano,2,1,1,4,Ocasional
8728,297,1,748.93,Clara Nunes,1,1,1,3,Inativo
8729,29,3,7892.34,Thiago Machado,3,1,4,8,Regular
8730,118,4,10384.99,Dr. Yan Almeida,1,2,4,7,Regular
8731,48,7,16679.96,Srta. Isabel Gonçalves,2,4,4,10,VIP
8732,29,5,9167.06,Vicente da Conceição,3,3,4,10,VIP
8733,32,5,839.64,José Pedro Fonseca,3,3,1,7,Regular
8734,67,8,7249.3099999999995,Dr. Lucas Freitas,2,4,3,9,Regular
8735,9,6,8904.77,Dr. Anthony Gabriel Viana,4,3,4,11,VIP
8736,45,5,5234.53,Giovanna Moreira,2,3,3,8,Regular
8737,30,8,6000.8,Lucas Guerra,3,4,3,10,VIP
8738,255,3,2849.72,Thales Ribeiro,1,1,2,4,Ocasional
8739,23,3,4704.29,Dr. Gabriel Barros,3,1,3,7,Regular
8740,12,4,3069.45,Ester Caldeira,4,2,2,8,Regular
8741,40,9,7045.57,Ravi Lucca Sales,3,4,3,10,VIP
8742,55,5,1305.41,Calebe da Cunha,2,3,1,6,Ocasional
8743,28,6,5659.93,Dr. Diogo Aparecida,3,3,3,9,Regular
8744,180,5,2137.94,Pietro Alves,1,3,1,5,Ocasional
8745,32,4,3883.5600000000004,Elisa Azevedo,3,2,2,7,Regular
8746,174,2,714.1800000000001,Maria Luísa Cardoso,1,1,1,3,Inativo
8747,92,3,3815.86,Dra. Sara Ferreira,1,1,2,4,Ocasional
8748,52,4,1595.0,Emanuella Aragão,2,2,1,5,Ocasional
8749,233,2,1309.44,Juan Azevedo,1,1,1,3,Inativo
8750,51,5,13286.23,Dr. Luiz Henrique Ribeiro,2,3,4,9,Regular
8751,50,9,15343.05,Vinícius Rodrigues,2,4,4,10,VIP
8752,36,10,6092.1900000000005,Ana Lívia Martins,3,4,3,10,VIP
8753,207,2,168.64,Sr. Anthony Novaes,1,1,1,3,Inativo
8754,8,8,10715.53,Otto Souza,4,4,4,12,VIP
8755,187,3,2840.35,Melina Pinto,1,1,2,4,Ocasional
8756,49,6,5057.150000000001,Davi Luiz Montenegro,2,3,3,8,Regular
8757,90,3,1148.71,Bernardo Almeida,1,1,1,3,Inativo
8758,91,5,4792.849999999999,Yasmin Dias,1,3,3,7,Regular
8759,198,3,2260.52,Bento Garcia,1,1,1,3,Inativo
8760,304,3,2669.59,Srta. Valentina da Rosa,1,1,2,4,Ocasional
8761,75,2,3327.06,Dra. Maria Julia Peixoto,2,1,2,5,Ocasional
8762,6,2,266.62,Isadora Lima,4,1,1,6,Ocasional
8763,84,7,6725.61,Pietro Sampaio,2,4,3,9,Regular
8764,67,4,2391.77,Pietra Carvalho,2,2,2,6,Ocasional
8765,14,5,1964.37,Breno da Mata,4,3,1,8,Regular
8766,51,3,7808.23,Emilly Garcia,2,1,4,7,Regular
8767,46,5,4542.66,Davi Lucas Moura,2,3,3,8,Regular
8768,30,3,4335.54,Sr. Josué das Neves,3,1,2,6,Ocasional
8769,15,4,5482.54,Emanuelly Lopes,4,2,3,9,Regular
8770,20,3,4919.07,Isaac Albuquerque,3,1,3,7,Regular
8771,35,4,1580.27,Asafe da Conceição,3,2,1,6,Ocasional
8772,221,2,472.07000000000005,Maria Fernanda da Rocha,1,1,1,3,Inativo
8773,26,4,7466.58,Letícia Viana,3,2,4,9,Regular
8774,25,8,8234.75,Lívia Mendes,3,4,4,11,VIP
8775,157,1,96.54,Breno Caldeira,1,1,1,3,Inativo
8776,22,7,5203.26,Eloah Caldeira,3,4,3,10,VIP
8777,197,6,7271.38,Srta. Maria Clara Guerra,1,3,3,7,Regular
8778,35,7,4250.97,Sophia Garcia,3,4,2,9,Regular
8779,50,2,2268.77,Eloá das Neves,2,1,2,5,Ocasional
8780,35,3,4344.92,Thales Fonseca,3,1,2,6,Ocasional
8781,54,5,7585.35,Maria Isis Cirino,2,3,4,9,Regular
8782,275,2,1917.28,Cauê da Cruz,1,1,1,3,Inativo
8783,116,3,2563.11,Sabrina Lopes,1,1,2,4,Ocasional
8784,79,3,869.13,Davi Lucca da Cruz,2,1,1,4,Ocasional
8785,23,4,5613.43,Alexandre Cardoso,3,2,3,8,Regular
8786,26,5,4154.41,Srta. Cecília Cavalcante,3,3,2,8,Regular
8787,21,7,10160.74,Benjamim da Luz,3,4,4,11,VIP
8788,136,3,4815.54,Murilo da Mata,1,1,3,5,Ocasional
8789,14,4,3394.97,Benício Campos,4,2,2,8,Regular
8790,44,5,3914.9700000000003,Diogo Lima,2,3,2,7,Regular
8791,51,7,19542.370000000003,Maria Júlia Almeida,2,4,4,10,VIP
8792,33,5,6799.22,Bianca Moreira,3,3,3,9,Regular
8793,11,2,2317.12,Henry Gabriel Santos,4,1,2,7,Regular
8794,72,5,5041.18,Sabrina Vasconcelos,2,3,3,8,Regular
8795,21,4,2423.49,Bruna da Mota,3,2,2,7,Regular
8796,6,2,987.1500000000001,Heloísa Vasconcelos,4,1,1,6,Ocasional
8797,6,10,8811.970000000001,Théo Montenegro,4,4,4,12,VIP
8798,157,3,3061.45,Sr. Vitor Hugo Sampaio,1,1,2,4,Ocasional
8799,8,5,7729.89,Ana Liz Pacheco,4,3,4,11,VIP
8800,51,3,1841.94,Cecília da Cunha,2,1,1,4,Ocasional
8801,43,1,853.04,Eduardo Nunes,3,1,1,5,Ocasional
8802,121,2,2466.27,Raquel Castro,1,1,2,4,Ocasional
8803,12,7,14869.02,Gael Vargas,4,4,4,12,VIP
8804,266,1,1003.72,Mariana Cavalcante,1,1,1,3,Inativo
8805,33,7,10553.460000000001,Alana Farias,3,4,4,11,VIP
8806,239,4,4890.98,Maria Julia da Mota,1,2,3,6,Ocasional
8807,9,6,5613.41,Ana Carolina Guerra,4,3,3,10,VIP
8808,45,5,9351.09,Bruna Pires,2,3,4,9,Regular
8809,252,3,982.1500000000001,Alícia Vieira,1,1,1,3,Inativo
8811,17,5,6334.84,Ana Cecília Pacheco,4,3,3,10,VIP
8812,37,5,7073.74,Aylla Souza,3,3,3,9,Regular
8813,15,4,1176.81,Eloá Pastor,4,2,1,7,Regular
8814,28,7,2667.06,Gabriela da Cruz,3,4,2,9,Regular
8815,168,1,1873.55,Emanuelly Nascimento,1,1,1,3,Inativo
8816,172,3,6456.65,Vinícius Lima,1,1,3,5,Ocasional
8817,26,3,3305.61,Ana Cecília Albuquerque,3,1,2,6,Ocasional
8818,233,3,9051.54,Luana Azevedo,1,1,4,6,Ocasional
8819,11,5,16150.75,Dra. Gabriela Caldeira,4,3,4,11,VIP
8820,64,5,1509.84,Sophia Pinto,2,3,1,6,Ocasional
8821,208,2,3097.83,Dra. Camila Nunes,1,1,2,4,Ocasional
8822,36,5,1971.4299999999998,Laís Sampaio,3,3,1,7,Regular
8823,13,8,13547.68,Sr. Marcelo Moraes,4,4,4,12,VIP
8825,9,8,6957.83,Théo Araújo,4,4,3,11,VIP
8826,57,3,2133.1400000000003,Pedro Lucas Barbosa,2,1,1,4,Ocasional
8827,156,5,3300.55,Lunna Melo,1,3,2,6,Ocasional
8828,26,5,12369.33,Benjamin Farias,3,3,4,10,VIP
8829,34,5,11559.06,Ágatha Pacheco,3,3,4,10,VIP
8830,7,8,12286.45,Calebe Fonseca,4,4,4,12,VIP
8831,19,6,6493.43,Heitor Vargas,4,3,3,10,VIP
8832,128,3,2247.76,Noah Souza,1,1,1,3,Inativo
8833,4,5,3405.9500000000003,Srta. Manuela Siqueira,4,3,2,9,Regular
8834,28,4,3800.6,Eloá Silveira,3,2,2,7,Regular
8835,183,3,1254.8,Sr. Luiz Felipe Barros,1,1,1,3,Inativo
8836,20,5,6445.91,Srta. Maria Liz Machado,3,3,3,9,Regular
8837,89,2,3789.26,Liam Farias,1,1,2,4,Ocasional
8838,73,4,3318.49,Maria Júlia Peixoto,2,2,2,6,Ocasional
8839,32,5,5767.04,Sr. Enzo Gabriel Silva,3,3,3,9,Regular
8840,43,4,713.1800000000001,Daniel Moraes,3,2,1,6,Ocasional
8841,245,2,408.09999999999997,Dra. Maria Julia Novais,1,1,1,3,Inativo
8842,16,5,4040.27,Maria Júlia Novais,4,3,2,9,Regular
8843,75,3,2442.56,Júlia Rocha,2,1,2,5,Ocasional
8844,32,2,2864.04,Lívia Moreira,3,1,2,6,Ocasional
8845,29,5,1870.37,João Miguel Gonçalves,3,3,1,7,Regular
8846,1,7,5409.719999999999,Maria Luísa Leão,4,4,3,11,VIP
8847,31,4,2344.4300000000003,Luigi Viana,3,2,2,7,Regular
8848,2,5,5604.13,Dr. Vinícius Fogaça,4,3,3,10,VIP
8849,23,6,6017.72,Manuela Alves,3,3,3,9,Regular
8850,331,1,1032.06,Milena Pereira,1,1,1,3,Inativo
8851,26,4,7740.71,Mateus Campos,3,2,4,9,Regular
8852,39,5,3322.25,Rodrigo Vasconcelos,3,3,2,8,Regular
8853,9,3,9730.22,Breno Caldeira,4,1,4,9,Regular
8854,21,1,105.48,Pietra da Paz,3,1,1,5,Ocasional
8855,15,7,5532.41,João Vitor da Conceição,4,4,3,11,VIP
8856,52,5,6223.32,Ana Laura Camargo,2,3,3,8,Regular
8857,5,5,2984.26,Eduarda Teixeira,4,3,2,9,Regular
8858,109,6,8812.25,Leandro Fogaça,1,3,4,8,Regular
8859,21,3,5413.45,Nicolas Correia,3,1,3,7,Regular
8860,136,3,4715.61,Maria Júlia Fernandes,1,1,3,5,Ocasional
8861,12,3,276.09,Apollo Guerra,4,1,1,6,Ocasional
8862,10,7,7222.74,Olivia da Rocha,4,4,3,11,VIP
8863,12,3,6088.26,Dra. Giovanna Freitas,4,1,3,8,Regular
8864,27,5,5010.8099999999995,Pedro Miguel Aragão,3,3,3,9,Regular
8865,24,6,7445.75,Emanuel Duarte,3,3,4,10,VIP
8866,7,7,3777.52,Fernanda da Rosa,4,4,2,10,VIP
8867,2,4,3443.65,José Miguel Silveira,4,2,2,8,Regular
8868,5,7,5033.5,Cecília Vasconcelos,4,4,3,11,VIP
8869,185,1,591.07,Fernando Gonçalves,1,1,1,3,Inativo
8870,23,6,4885.03,Maria Cecília Cirino,3,3,3,9,Regular
8871,9,9,9889.05,Lunna Andrade,4,4,4,12,VIP
8872,7,7,8050.2300000000005,Dra. Brenda Sá,4,4,4,12,VIP
8873,7,3,5127.11,Stella Ferreira,4,1,3,8,Regular
8874,50,3,5195.6,Dr. Carlos Eduardo Correia,2,1,3,6,Ocasional
8875,113,4,2256.9300000000003,Gael Fonseca,1,2,1,4,Ocasional
8876,3,8,6559.57,Sr. Bento Barbosa,4,4,3,11,VIP
8877,9,2,942.0500000000001,Heloísa Silveira,4,1,1,6,Ocasional
8878,219,4,1782.0400000000002,Thiago Mendes,1,2,1,4,Ocasional
8879,5,4,12076.11,Isabella Macedo,4,2,4,10,VIP
8880,70,4,6615.6,Marcos Vinicius Pires,2,2,3,7,Regular
8881,9,6,13797.5,Daniela Sampaio,4,3,4,11,VIP
8883,9,7,13282.099999999999,Ísis Cunha,4,4,4,12,VIP
8884,148,3,8855.85,Nicolas da Cunha,1,1,4,6,Ocasional
8885,30,7,10912.33,Sr. João Miguel Sales,3,4,4,11,VIP
8886,108,3,4502.37,Pietro Lima,1,1,3,5,Ocasional
8887,34,5,1956.6399999999999,Leonardo Albuquerque,3,3,1,7,Regular
8888,42,7,7705.66,Zoe Jesus,3,4,4,11,VIP
8889,193,2,631.75,Davi Lucas das Neves,1,1,1,3,Inativo
8890,39,3,5245.8,Olivia Guerra,3,1,3,7,Regular
8891,20,3,1803.8500000000001,Helena Caldeira,3,1,1,5,Ocasional
8892,32,4,2671.27,Ana Liz Machado,3,2,2,7,Regular
8893,48,7,8996.79,Kevin Garcia,2,4,4,10,VIP
8894,40,5,5718.29,Rafaela Gomes,3,3,3,9,Regular
8895,47,2,573.84,Dra. Joana da Mata,2,1,1,4,Ocasional
8896,61,2,300.22,Sra. Sara Freitas,2,1,1,4,Ocasional
8897,29,5,6537.07,Isadora Vieira,3,3,3,9,Regular
8898,63,2,1015.94,Mateus Souza,2,1,1,4,Ocasional
8899,27,3,4369.05,Benicio Nascimento,3,1,2,6,Ocasional
8900,29,7,13536.43,Beatriz Garcia,3,4,4,11,VIP
8901,12,7,18514.97,Oliver Pastor,4,4,4,12,VIP
8902,47,5,2550.58,Dra. Hellena Campos,2,3,2,7,Regular
8903,24,6,4220.54,Sr. Eduardo Aparecida,3,3,2,8,Regular
8904,23,6,5920.09,Brenda Souza,3,3,3,9,Regular
8905,40,4,5879.52,Isadora Novais,3,2,3,8,Regular
8906,58,6,6911.24,Maria Laura Freitas,2,3,3,8,Regular
8907,26,4,8975.49,Renan Nascimento,3,2,4,9,Regular
8908,39,6,8747.09,Dra. Maya Andrade,3,3,4,10,VIP
8909,83,4,2175.69,Ana Lívia Cavalcanti,2,2,1,5,Ocasional
8910,26,7,3310.7,Théo Melo,3,4,2,9,Regular
8911,36,2,8827.48,Bernardo Moreira,3,1,4,8,Regular
8912,44,2,3115.04,Gabrielly Nunes,2,1,2,5,Ocasional
8913,31,4,4784.44,Dr. Yago Martins,3,2,3,8,Regular
8914,33,3,757.0799999999999,João Costela,3,1,1,5,Ocasional
8915,12,7,5135.22,Hadassa Aragão,4,4,3,11,VIP
8916,63,5,4235.38,João Miguel Novais,2,3,2,7,Regular
8917,75,2,1054.3,Rhavi da Cunha,2,1,1,4,Ocasional
8918,54,1,276.0,Dr. Gabriel Sousa,2,1,1,4,Ocasional
8919,67,4,5351.9,Vitor Hugo da Rocha,2,2,3,7,Regular
8920,29,8,14590.12,Clarice da Costa,3,4,4,11,VIP
8921,10,5,4209.9800000000005,Heitor Sales,4,3,2,9,Regular
8922,17,7,10807.23,Sr. Fernando Jesus,4,4,4,12,VIP
8923,23,5,5241.099999999999,Davi Miguel Nunes,3,3,3,9,Regular
8924,100,3,3696.11,Kaique Ferreira,1,1,2,4,Ocasional
8925,42,3,973.53,Yan Lopes,3,1,1,5,Ocasional
8926,125,1,1241.74,Danilo da Mata,1,1,1,3,Inativo
8927,4,3,6255.87,Eduarda Silveira,4,1,3,8,Regular
8928,25,3,9311.34,Caio Aragão,3,1,4,8,Regular
8929,68,1,1633.05,Clara Pinto,2,1,1,4,Ocasional
8930,2,4,8165.29,Evelyn Cassiano,4,2,4,10,VIP
8931,239,1,1104.86,Dra. Isabel Câmara,1,1,1,3,Inativo
8932,80,3,2272.32,Alexia Nogueira,2,1,2,5,Ocasional
8933,188,2,4307.62,Pietra Rocha,1,1,2,4,Ocasional
8934,20,4,11056.669999999998,Bruna Pires,3,2,4,9,Regular
8935,110,5,7005.860000000001,Natália Fernandes,1,3,3,7,Regular
8936,56,2,439.55,Enrico Fernandes,2,1,1,4,Ocasional
8937,4,6,7213.1900000000005,Sra. Melina Vasconcelos,4,3,3,10,VIP
8938,114,1,264.89,Maitê da Mata,1,1,1,3,Inativo
8939,35,5,3402.7799999999997,Yan da Mota,3,3,2,8,Regular
8940,58,3,1266.73,Carolina Nascimento,2,1,1,4,Ocasional
8941,6,6,1909.84,Caleb Brito,4,3,1,8,Regular
8942,23,6,9329.55,Maria Isis Santos,3,3,4,10,VIP
8943,216,2,6349.110000000001,Vinícius Abreu,1,1,3,5,Ocasional
8945,10,5,8476.95,Davi Miguel Moura,4,3,4,11,VIP
8946,135,5,6014.049999999999,Elisa Cavalcanti,1,3,3,7,Regular
8947,39,10,9214.84,Maria Julia Câmara,3,4,4,11,VIP
8948,18,7,5112.74,Alice Leão,4,4,3,11,VIP
8949,35,7,5677.6900000000005,Enzo Gabriel Pastor,3,4,3,10,VIP
8950,41,2,2645.65,Lucas Gabriel Montenegro,3,1,2,6,Ocasional
8951,2,5,2121.06,Srta. Bianca Freitas,4,3,1,8,Regular
8952,24,8,12731.98,Ayla Cirino,3,4,4,11,VIP
8953,105,4,4472.34,André Sousa,1,2,3,6,Ocasional
8954,9,6,6995.51,Sra. Cecilia Câmara,4,3,3,10,VIP
8955,3,8,11961.529999999999,Ana Clara Nascimento,4,4,4,12,VIP
8956,37,4,7508.83,Anna Liz Pastor,3,2,4,9,Regular
8957,7,5,5463.66,Srta. Ana Lívia Mendes,4,3,3,10,VIP
8958,4,5,9127.28,Alexia Vasconcelos,4,3,4,11,VIP
8959,57,3,1866.83,Sofia Casa Grande,2,1,1,4,Ocasional
8960,32,3,4502.18,Dr. Leonardo Ramos,3,1,3,7,Regular
8961,38,3,2127.52,Sra. Maria Eduarda Casa Grande,3,1,1,5,Ocasional
8962,310,1,643.7,Alexia da Rocha,1,1,1,3,Inativo
8963,38,5,10643.58,Gabriel Silveira,3,3,4,10,VIP
8964,42,2,2620.51,Murilo Câmara,3,1,2,6,Ocasional
8965,59,6,4996.820000000001,Raquel Freitas,2,3,3,8,Regular
8966,38,6,7425.599999999999,Olivia Leão,3,3,4,10,VIP
8967,28,4,3092.3599999999997,Laís da Mota,3,2,2,7,Regular
8968,202,5,6336.0599999999995,Bernardo Fernandes,1,3,3,7,Regular
8969,20,3,2884.42,Maria Flor Barros,3,1,2,6,Ocasional
8970,26,3,723.95,Bryan Barros,3,1,1,5,Ocasional
8971,216,6,9358.3,Sr. Pedro Lucas Moura,1,3,4,8,Regular
8972,42,4,2655.94,Camila Rocha,3,2,2,7,Regular
8973,161,5,3000.64,Srta. Isabel Brito,1,3,2,6,Ocasional
8974,64,3,1692.9199999999998,Ana Carolina Duarte,2,1,1,4,Ocasional
8975,63,2,1404.68,Ana Cecília Camargo,2,1,1,4,Ocasional
8976,4,5,3401.58,Bruno Teixeira,4,3,2,9,Regular
8977,38,4,7373.64,Bento Freitas,3,2,4,9,Regular
8978,77,2,437.88,Bruna Albuquerque,2,1,1,4,Ocasional
8979,116,4,1868.23,Cauã da Paz,1,2,1,4,Ocasional
8980,15,5,4586.26,Francisco Oliveira,4,3,3,10,VIP
8981,51,9,13281.039999999999,Arthur Peixoto,2,4,4,10,VIP
8982,62,3,2877.16,Sra. Helena Campos,2,1,2,5,Ocasional
8983,43,3,3300.04,Antonella Pereira,3,1,2,6,Ocasional
8984,13,3,7991.87,Igor Santos,4,1,4,9,Regular
8985,30,4,11375.52,João Felipe Macedo,3,2,4,9,Regular
8986,100,2,2648.06,João Miguel Lima,1,1,2,4,Ocasional
8987,6,7,6287.44,Sr. Davi Machado,4,4,3,11,VIP
8988,10,8,12682.77,Raul Mendonça,4,4,4,12,VIP
8989,129,3,1504.95,Marcos Vinicius Gonçalves,1,1,1,3,Inativo
8990,92,4,4768.219999999999,Luiz Otávio Borges,1,2,3,6,Ocasional
8991,262,1,481.47,Ana Luiza Souza,1,1,1,3,Inativo
8992,84,6,22249.56,Maria Eduarda Duarte,2,3,4,9,Regular
8993,20,5,5518.65,Sophie Cirino,3,3,3,9,Regular
8994,9,7,13220.29,Vitória Nunes,4,4,4,12,VIP
8995,74,5,9888.64,Carlos Eduardo Ribeiro,2,3,4,9,Regular
8996,69,2,6129.53,Alexandre Marques,2,1,3,6,Ocasional
8997,36,3,2116.71,Milena Oliveira,3,1,1,5,Ocasional
8998,58,3,884.3299999999999,Henrique Viana,2,1,1,4,Ocasional
8999,131,2,9663.99,Sarah Peixoto,1,1,4,6,Ocasional
9000,49,6,4816.81,Maria Cecília Camargo,2,3,3,8,Regular
9001,5,5,3606.1200000000003,João Gabriel Barros,4,3,2,9,Regular
9002,175,3,2167.53,Aurora Abreu,1,1,1,3,Inativo
9003,1,6,5469.24,Dra. Vitória Sá,4,3,3,10,VIP
9004,91,2,275.45000000000005,Srta. Maria Luiza Aragão,1,1,1,3,Inativo
9005,7,8,16416.329999999998,Bruna Cavalcanti,4,4,4,12,VIP
9006,364,1,770.12,Enrico Ramos,1,1,1,3,Inativo
9007,10,4,1403.2,Ana Júlia Pires,4,2,1,7,Regular
9008,18,4,2990.06,Kamilly Mendonça,4,2,2,8,Regular
9009,30,5,5787.0,Sra. Camila Dias,3,3,3,9,Regular
9010,3,4,2292.27,Dra. Maria Julia Pinto,4,2,2,8,Regular
9011,51,6,7612.41,Aylla Barbosa,2,3,4,9,Regular
9012,32,4,3744.1000000000004,Marcelo da Luz,3,2,2,7,Regular
9013,10,5,3361.94,Caroline Fernandes,4,3,2,9,Regular
9014,75,4,5307.65,Ana Vitória Novais,2,2,3,7,Regular
9015,37,5,2775.82,Pedro Miguel Jesus,3,3,2,8,Regular
9016,84,2,4782.54,Sr. Bruno da Cruz,2,1,3,6,Ocasional
9017,45,6,3173.2800000000007,Júlia Siqueira,2,3,2,7,Regular
9018,2,4,3349.7099999999996,Srta. Maysa Fonseca,4,2,2,8,Regular
9019,17,3,3835.59,Vicente Camargo,4,1,2,7,Regular
9020,1,7,17475.02,Guilherme Jesus,4,4,4,12,VIP
9021,78,1,1624.77,Dra. Laís Cardoso,2,1,1,4,Ocasional
9022,47,4,1619.01,Srta. Stella Carvalho,2,2,1,5,Ocasional
9023,66,4,2433.25,Srta. Melissa Teixeira,2,2,2,6,Ocasional
9024,12,7,6045.39,Anthony Gabriel Teixeira,4,4,3,11,VIP
9025,19,9,17776.870000000003,Luiz Fernando Vieira,4,4,4,12,VIP
9026,53,2,2205.62,Sr. Vicente Azevedo,2,1,1,4,Ocasional
9027,91,2,1027.97,Dr. Francisco da Conceição,1,1,1,3,Inativo
9028,46,6,3502.6200000000003,Igor Nascimento,2,3,2,7,Regular
9029,143,1,2148.8,Gabrielly Casa Grande,1,1,1,3,Inativo
9030,54,7,12769.01,Helena Peixoto,2,4,4,10,VIP
9031,19,4,1450.37,Maria Júlia Barbosa,4,2,1,7,Regular
9032,39,2,1012.0,Valentim Nogueira,3,1,1,5,Ocasional
9033,6,7,8595.1,Bárbara Duarte,4,4,4,12,VIP
9034,159,4,1593.6100000000001,Caleb Fonseca,1,2,1,4,Ocasional
9035,50,4,7536.9,Luiz Miguel da Cruz,2,2,4,8,Regular
9036,14,7,6136.86,Maria Julia Cavalcanti,4,4,3,11,VIP
9037,209,3,2582.3,Sr. Valentim Novais,1,1,2,4,Ocasional
9038,70,6,7273.33,Dr. Davi Lucas Cassiano,2,3,3,8,Regular
9039,60,7,12116.72,Stella Moreira,2,4,4,10,VIP
9040,52,5,7663.639999999999,Sr. João Miguel Albuquerque,2,3,4,9,Regular
9041,159,3,4461.17,Dr. Dom Pacheco,1,1,3,5,Ocasional
9042,2,8,13654.38,Maya Cavalcante,4,4,4,12,VIP
9043,4,3,1436.3700000000001,Dra. Esther Novais,4,1,1,6,Ocasional
9044,7,4,5172.35,Matheus Fernandes,4,2,3,9,Regular
9045,98,7,11257.28,Sra. Maria Isis Teixeira,1,4,4,9,Regular
9046,86,7,5427.41,Olivia Araújo,2,4,3,9,Regular
9047,50,6,9763.26,Maria Júlia da Mota,2,3,4,9,Regular
9048,116,4,3771.4300000000003,Ana Luiza Moura,1,2,2,5,Ocasional
9049,26,5,1495.79,Ana Liz Porto,3,3,1,7,Regular
9050,2,5,7169.82,Luísa Alves,4,3,3,10,VIP
9051,26,9,12781.11,Henry Gabriel Aparecida,3,4,4,11,VIP
9052,2,3,5859.4800000000005,Maria Sophia Teixeira,4,1,3,8,Regular
9053,56,2,5722.2,Esther Silva,2,1,3,6,Ocasional
9054,64,4,1767.11,Antonella Ramos,2,2,1,5,Ocasional
9055,45,7,10981.44,Isadora Fogaça,2,4,4,10,VIP
9056,30,5,6060.52,Anthony Gabriel Pinto,3,3,3,9,Regular
9057,39,6,7096.179999999999,Maria Clara Siqueira,3,3,3,9,Regular
9058,20,6,5362.74,Dr. José Miguel Pimenta,3,3,3,9,Regular
9059,20,4,3869.9400000000005,Srta. Esther Duarte,3,2,2,7,Regular
9060,57,7,8802.439999999999,Pietro Ferreira,2,4,4,10,VIP
9061,86,5,3574.16,Arthur Lima,2,3,2,7,Regular
9062,23,2,663.5600000000001,Maysa Ramos,3,1,1,5,Ocasional
9063,16,5,9862.84,Lucas Gabriel Dias,4,3,4,11,VIP
9064,195,7,13754.59,Sra. Lavínia Cavalcanti,1,4,4,9,Regular
9065,5,4,9506.630000000001,Pedro Lucas Aparecida,4,2,4,10,VIP
9066,44,8,15542.81,Henrique da Paz,2,4,4,10,VIP
9068,49,5,2660.11,Isabel Castro,2,3,2,7,Regular
9069,142,5,6363.78,Breno Rocha,1,3,3,7,Regular
9070,5,4,7664.389999999999,Ana Júlia Rodrigues,4,2,4,10,VIP
9071,62,1,2438.31,Sra. Maitê Cunha,2,1,2,5,Ocasional
9072,1,5,2889.1499999999996,Davi Aparecida,4,3,2,9,Regular
9073,228,2,3176.16,Bernardo Nascimento,1,1,2,4,Ocasional
9074,26,1,212.8,Arthur Miguel Farias,3,1,1,5,Ocasional
9075,8,3,2752.3199999999997,Sr. Renan Cavalcante,4,1,2,7,Regular
9076,226,1,425.74,Sophie da Rosa,1,1,1,3,Inativo
9077,199,3,6040.73,Vinicius Brito,1,1,3,5,Ocasional
9078,47,6,9338.54,Maria Luísa Barros,2,3,4,9,Regular
9079,10,8,7880.64,Pietro Costela,4,4,4,12,VIP
9080,30,3,4665.42,Caleb Martins,3,1,3,7,Regular
9081,70,7,8021.75,Laís Guerra,2,4,4,10,VIP
9082,13,5,5097.7,Stella Correia,4,3,3,10,VIP
9083,50,7,6082.83,Joaquim Lopes,2,4,3,9,Regular
9084,18,5,6186.73,Ravi Lucca Azevedo,4,3,3,10,VIP
9085,80,2,2905.9300000000003,Vitória Novais,2,1,2,5,Ocasional
9086,142,5,11069.519999999999,Matheus Câmara,1,3,4,8,Regular
9087,64,6,12258.369999999999,Anthony Gabriel Costa,2,3,4,9,Regular
9088,54,4,5855.9400000000005,Lívia Moreira,2,2,3,7,Regular
9089,44,6,7182.3,Gabrielly Moraes,2,3,3,8,Regular
9090,23,8,10538.98,Murilo Vargas,3,4,4,11,VIP
9091,54,4,7565.7,Calebe Melo,2,2,4,8,Regular
9092,87,6,6200.45,Calebe Brito,2,3,3,8,Regular
9093,79,4,7776.77,Lívia Montenegro,2,2,4,8,Regular
9094,57,7,14501.37,Luana Vargas,2,4,4,10,VIP
9095,112,5,4163.43,João Guilherme Ribeiro,1,3,2,6,Ocasional
9096,32,3,5139.54,Henry Vargas,3,1,3,7,Regular
9097,78,3,5440.82,Sarah Costa,2,1,3,6,Ocasional
9098,80,4,6432.43,João Felipe Teixeira,2,2,3,7,Regular
9099,53,4,10267.22,Nicole Porto,2,2,4,8,Regular
9100,23,5,9331.42,Sra. Anna Liz Costa,3,3,4,10,VIP
9101,10,2,1127.37,Isabela Azevedo,4,1,1,6,Ocasional
9102,14,3,2019.5100000000002,Sr. Henry Gabriel Garcia,4,1,1,6,Ocasional
9103,37,5,1746.45,Marina Macedo,3,3,1,7,Regular
9104,45,6,5319.88,Eloá Machado,2,3,3,8,Regular
9105,20,5,8980.61,Clara Montenegro,3,3,4,10,VIP
9106,34,5,14414.75,Maya da Paz,3,3,4,10,VIP
9107,216,1,152.51,Sara Marques,1,1,1,3,Inativo
9108,117,3,7120.9800000000005,Antony Sá,1,1,3,5,Ocasional
9109,155,2,1582.62,Antonella Andrade,1,1,1,3,Inativo
9110,19,5,4373.82,Maitê Pimenta,4,3,3,10,VIP
9111,63,3,3678.14,Matheus Farias,2,1,2,5,Ocasional
9112,37,8,3185.69,Maya Moraes,3,4,2,9,Regular
9113,84,4,3946.7200000000003,Eduarda Dias,2,2,2,6,Ocasional
9114,84,5,3368.5699999999997,Enzo Martins,2,3,2,7,Regular
9115,13,8,7678.07,Sophie Pimenta,4,4,4,12,VIP
9116,20,2,926.21,Ágatha Ribeiro,3,1,1,5,Ocasional
9117,205,2,1769.5,Emilly Montenegro,1,1,1,3,Inativo
9118,15,5,2204.97,Miguel Aparecida,4,3,1,8,Regular
9119,16,5,2835.17,Ana Sophia da Cruz,4,3,2,9,Regular
9120,4,6,20844.55,Valentina Pires,4,3,4,11,VIP
9121,7,6,6813.08,Thales Pereira,4,3,3,10,VIP
9122,55,5,3173.23,Fernanda Teixeira,2,3,2,7,Regular
9123,19,3,365.88,Juan Freitas,4,1,1,6,Ocasional
9124,55,4,8061.2300000000005,Emilly Alves,2,2,4,8,Regular
9125,9,6,5939.139999999999,Sr. João Lucas Gomes,4,3,3,10,VIP
9126,44,8,18216.09,Joaquim Rocha,2,4,4,10,VIP
9127,25,5,1827.8799999999999,Isadora Cavalcante,3,3,1,7,Regular
9128,85,7,5932.09,Dr. Yuri Fernandes,2,4,3,9,Regular
9129,80,1,453.64,Sr. Yan Aragão,2,1,1,4,Ocasional
9130,18,4,3649.71,Theodoro Rodrigues,4,2,2,8,Regular
9131,13,4,3038.66,Srta. Maria Barros,4,2,2,8,Regular
9132,137,2,675.4200000000001,Cecilia Cavalcante,1,1,1,3,Inativo
9133,35,2,2292.0699999999997,Josué Campos,3,1,2,6,Ocasional
9134,28,5,3698.29,Maria Casa Grande,3,3,2,8,Regular
9135,36,7,4096.16,Valentim Azevedo,3,4,2,9,Regular
9136,52,3,351.78999999999996,Dante da Rocha,2,1,1,4,Ocasional
9137,17,5,9346.529999999999,Paulo Cirino,4,3,4,11,VIP
9138,61,7,7050.79,Fernanda Albuquerque,2,4,3,9,Regular
9139,73,2,2075.95,Vinicius Almeida,2,1,1,4,Ocasional
9140,128,1,202.87,Ana Luiza Fogaça,1,1,1,3,Inativo
9141,134,3,2118.17,Amanda Nogueira,1,1,1,3,Inativo
9142,49,1,866.61,Daniela Sousa,2,1,1,4,Ocasional
9143,20,7,3830.18,Srta. Beatriz da Luz,3,4,2,9,Regular
9144,2,5,6616.51,Gabriel Novaes,4,3,3,10,VIP
9145,3,4,9280.51,Alice Novaes,4,2,4,10,VIP
9146,72,4,3570.2699999999995,Sr. Thiago Machado,2,2,2,6,Ocasional
9147,33,7,6240.67,Dr. Davi Martins,3,4,3,10,VIP
9148,45,5,9558.33,Dra. Alana Martins,2,3,4,9,Regular
9149,171,3,806.4000000000001,Thiago Câmara,1,1,1,3,Inativo
9150,44,10,12677.02,Joana Barros,2,4,4,10,VIP
9151,26,6,6091.59,Mateus Peixoto,3,3,3,9,Regular
9152,92,2,1694.2,Maria Helena Cirino,1,1,1,3,Inativo
9153,294,3,1123.39,Sr. Raul Mendes,1,1,1,3,Inativo
9154,18,5,4983.54,Antony Leão,4,3,3,10,VIP
9155,3,6,12672.61,Mariana Correia,4,3,4,11,VIP
9156,159,5,9205.91,Luana Brito,1,3,4,8,Regular
9157,33,3,3879.63,José Farias,3,1,2,6,Ocasional
9158,24,5,4333.05,Theodoro da Mota,3,3,2,8,Regular
9159,91,4,4452.18,João Pedro Nunes,1,2,3,6,Ocasional
9160,60,2,2138.03,Dra. Sophia Rocha,2,1,1,4,Ocasional
9161,8,8,15240.91,Agatha Rezende,4,4,4,12,VIP
9162,17,8,11908.75,Dra. Maria Helena Costa,4,4,4,12,VIP
9163,100,1,719.37,Mariana Peixoto,1,1,1,3,Inativo
9164,107,5,5418.26,Maria Cecília Rios,1,3,3,7,Regular
9165,168,5,11237.89,Thiago Cavalcanti,1,3,4,8,Regular
9166,135,4,4249.4,Yasmin Martins,1,2,2,5,Ocasional
9167,52,4,6745.74,João Felipe Silveira,2,2,3,7,Regular
9168,11,6,5216.59,Dr. Vitor Gabriel Aragão,4,3,3,10,VIP
9170,48,5,6515.540000000001,Carolina Cirino,2,3,3,8,Regular
9171,46,3,2865.08,João da Rocha,2,1,2,5,Ocasional
9172,71,6,9733.05,Noah Ramos,2,3,4,9,Regular
9173,40,7,7151.97,Alexia da Costa,3,4,3,10,VIP
9174,4,4,7248.349999999999,Valentina Casa Grande,4,2,3,9,Regular
9175,44,6,3000.55,Sra. Maria Sophia da Cunha,2,3,2,7,Regular
9176,84,4,1615.5800000000002,Maria Helena Duarte,2,2,1,5,Ocasional
9177,18,4,8330.98,Samuel da Cruz,4,2,4,10,VIP
9178,8,4,6150.25,Ana Luiza das Neves,4,2,3,9,Regular
9179,25,3,1502.28,Bruna Machado,3,1,1,5,Ocasional
9180,57,1,2780.01,Davi Luiz Mendes,2,1,2,5,Ocasional
9181,37,9,12965.71,Rebeca Costela,3,4,4,11,VIP
9182,156,3,2553.6,Bruno Siqueira,1,1,2,4,Ocasional
9183,78,7,2148.94,Sr. Luiz Miguel Oliveira,2,4,1,7,Regular
9184,36,7,2729.73,Maria Alice Câmara,3,4,2,9,Regular
9185,22,3,1728.96,Arthur Miguel Sá,3,1,1,5,Ocasional
9186,19,6,17209.46,Sr. Thomas Almeida,4,3,4,11,VIP
9187,5,4,8248.08,Sr. José Miguel Rios,4,2,4,10,VIP
9188,4,5,4124.24,Srta. Stella Mendes,4,3,2,9,Regular
9189,8,5,5373.17,Helena Cavalcanti,4,3,3,10,VIP
9190,38,5,5464.67,Ester Teixeira,3,3,3,9,Regular
9191,75,4,5029.4,Fernando Barros,2,2,3,7,Regular
9192,16,7,12151.24,Sra. Maria Luísa da Paz,4,4,4,12,VIP
9193,3,2,8082.5,Luna Costa,4,1,4,9,Regular
9194,33,4,9414.02,Olivia Silva,3,2,4,9,Regular
9195,43,7,5485.41,Maria Vitória da Costa,3,4,3,10,VIP
9196,315,1,780.36,Joana Dias,1,1,1,3,Inativo
9197,4,3,3092.4700000000003,Ana da Costa,4,1,2,7,Regular
9198,2,6,7044.860000000001,Luiz Felipe Alves,4,3,3,10,VIP
9199,1,4,8293.87,Benicio Lima,4,2,4,10,VIP
9200,20,3,4185.51,Maria Julia Vargas,3,1,2,6,Ocasional
9201,89,4,4586.32,Luiz Felipe Viana,1,2,3,6,Ocasional
9202,284,2,264.23,Lorena Mendes,1,1,1,3,Inativo
9203,255,1,576.95,Bernardo Vieira,1,1,1,3,Inativo
9204,174,1,6023.8,Isis Siqueira,1,1,3,5,Ocasional
9205,144,2,322.35,Pietro Martins,1,1,1,3,Inativo
9206,37,6,11012.539999999999,Rodrigo Vieira,3,3,4,10,VIP
9207,21,2,1807.46,Isabelly Cassiano,3,1,1,5,Ocasional
9208,65,6,18351.84,João Felipe Montenegro,2,3,4,9,Regular
9209,6,6,12186.82,Stella Pacheco,4,3,4,11,VIP
9210,96,3,2408.52,Luiz Fernando Garcia,1,1,2,4,Ocasional
9211,23,4,7970.65,Sra. Aylla Abreu,3,2,4,9,Regular
9212,61,3,1612.4,Clara Duarte,2,1,1,4,Ocasional
9213,33,3,1303.0,Agatha Cirino,3,1,1,5,Ocasional
9214,26,5,15349.11,Isabelly da Rosa,3,3,4,10,VIP
9215,113,4,1727.65,Vitor Gabriel Nunes,1,2,1,4,Ocasional
9216,1,4,4024.58,Igor da Costa,4,2,2,8,Regular
9217,308,2,4115.639999999999,Igor Leão,1,1,2,4,Ocasional
9218,40,2,1094.1499999999999,Sr. Dom Novais,3,1,1,5,Ocasional
9219,66,4,2576.3199999999997,Luana Almeida,2,2,2,6,Ocasional
9220,46,5,5220.49,Lara Ribeiro,2,3,3,8,Regular
9221,37,4,7437.51,Maria Clara Mendes,3,2,4,9,Regular
9222,5,5,1239.33,Dante Brito,4,3,1,8,Regular
9223,16,1,1354.49,Igor Cirino,4,1,1,6,Ocasional
9224,13,2,6039.99,Mariane Souza,4,1,3,8,Regular
9225,113,4,7719.38,Thales Campos,1,2,4,7,Regular
9226,12,4,5065.59,Sabrina Farias,4,2,3,9,Regular
9227,1,5,6655.79,Sr. Bruno Guerra,4,3,3,10,VIP
9228,60,7,6373.25,Francisco Barbosa,2,4,3,9,Regular
9229,67,4,2175.0099999999998,Maria Alice Cavalcante,2,2,1,5,Ocasional
9230,9,8,11989.24,Maria Luiza Sá,4,4,4,12,VIP
9231,55,5,1649.24,Eloah Brito,2,3,1,6,Ocasional
9232,7,3,2290.28,Vitor Hugo Castro,4,1,2,7,Regular
9233,90,3,3869.27,Igor Cavalcanti,1,1,2,4,Ocasional
9234,2,6,8284.28,Danilo Abreu,4,3,4,11,VIP
9235,35,8,11722.060000000001,Dra. Maya Rezende,3,4,4,11,VIP
9236,52,9,11745.38,Luiz Otávio da Mata,2,4,4,10,VIP
9237,57,3,1374.4099999999999,Olivia Andrade,2,1,1,4,Ocasional
9238,81,1,848.75,Marina Pacheco,2,1,1,4,Ocasional
9239,59,1,109.08,Lucas Martins,2,1,1,4,Ocasional
9240,89,1,1094.2,Allana Fonseca,1,1,1,3,Inativo
9241,3,5,7319.24,Maria Liz Aparecida,4,3,4,11,VIP
9242,35,4,5839.71,Diogo Novais,3,2,3,8,Regular
9243,29,5,10358.14,Ana Lívia Peixoto,3,3,4,10,VIP
9244,12,2,2568.75,Erick Lopes,4,1,2,7,Regular
9245,28,3,4376.47,Sr. Vicente Vargas,3,1,3,7,Regular
9246,90,1,196.68,Srta. Hellena Castro,1,1,1,3,Inativo
9247,239,1,500.32,Kaique Siqueira,1,1,1,3,Inativo
9248,76,4,6946.32,Srta. Luiza das Neves,2,2,3,7,Regular
9249,54,6,4272.280000000001,Maria Flor Fernandes,2,3,2,7,Regular
9250,6,5,6804.37,Dr. Isaac Oliveira,4,3,3,10,VIP
9251,125,2,593.4,Benicio Caldeira,1,1,1,3,Inativo
9252,67,2,6784.69,Kamilly Câmara,2,1,3,6,Ocasional
9253,87,5,4345.36,Maria Luísa Sampaio,2,3,2,7,Regular
9254,68,3,1932.42,Fernanda Fogaça,2,1,1,4,Ocasional
9255,201,3,2930.6400000000003,Clara da Cunha,1,1,2,4,Ocasional
9256,47,3,2360.24,Eduardo Borges,2,1,2,5,Ocasional
9257,22,5,4073.84,Dr. Benjamim Cavalcante,3,3,2,8,Regular
9258,57,3,5560.61,Yuri Silveira,2,1,3,6,Ocasional
9259,180,2,3197.9399999999996,Pedro Henrique Moraes,1,1,2,4,Ocasional
9260,191,1,349.48,Bruna Albuquerque,1,1,1,3,Inativo
9261,109,5,6479.67,Nathan das Neves,1,3,3,7,Regular
9262,245,3,6132.24,Bruno Aragão,1,1,3,5,Ocasional
9263,68,5,8453.93,Paulo Brito,2,3,4,9,Regular
9264,239,3,1945.79,Théo Brito,1,1,1,3,Inativo
9265,22,4,4380.46,Rael Mendonça,3,2,3,8,Regular
9266,43,3,7535.959999999999,Isabelly Camargo,3,1,4,8,Regular
9267,205,1,734.87,Ísis da Conceição,1,1,1,3,Inativo
9268,45,4,9546.88,Leonardo Farias,2,2,4,8,Regular
9269,11,4,7494.48,Marcelo da Mata,4,2,4,10,VIP
9270,28,5,4248.75,Luana Machado,3,3,2,8,Regular
9271,84,4,9776.61,Théo Rocha,2,2,4,8,Regular
9272,80,6,5529.200000000001,Caio Costela,2,3,3,8,Regular
9273,2,5,5962.45,Mirella Nunes,4,3,3,10,VIP
9274,49,4,2005.23,Lucas Oliveira,2,2,1,5,Ocasional
9275,4,7,6812.63,Sra. Hellena Abreu,4,4,3,11,VIP
9276,75,1,294.65,Felipe Moreira,2,1,1,4,Ocasional
9277,91,5,3738.29,Stella Mendes,1,3,2,6,Ocasional
9278,12,6,3855.41,Sabrina Carvalho,4,3,2,9,Regular
9279,127,5,2004.6,Sr. Diogo Barbosa,1,3,1,5,Ocasional
9280,8,8,5890.59,Theo Nascimento,4,4,3,11,VIP
9281,176,2,3185.74,Maria Júlia Farias,1,1,2,4,Ocasional
9282,283,3,1472.09,Clarice Teixeira,1,1,1,3,Inativo
9283,3,8,14347.300000000001,Dr. Valentim Brito,4,4,4,12,VIP
9284,47,4,1684.74,Benjamin Almeida,2,2,1,5,Ocasional
9285,241,1,602.05,Benício Moura,1,1,1,3,Inativo
9286,133,6,4770.22,Sra. Ana Sophia Viana,1,3,3,7,Regular
9287,46,4,1802.98,Clara Montenegro,2,2,1,5,Ocasional
9288,6,3,2469.37,Bernardo Leão,4,1,2,7,Regular
9289,82,7,5632.48,Marcelo Silva,2,4,3,9,Regular
9290,70,6,2643.95,João Rios,2,3,2,7,Regular
9292,223,4,2494.53,Lunna Moura,1,2,2,5,Ocasional
9293,91,2,4073.87,Renan Novaes,1,1,2,4,Ocasional
9294,52,10,14829.32,Sr. Caleb Cassiano,2,4,4,10,VIP
9295,89,6,16993.989999999998,Hellena Barbosa,1,3,4,8,Regular
9296,114,4,10381.51,Dante Borges,1,2,4,7,Regular
9297,19,6,8780.75,Thomas Garcia,4,3,4,11,VIP
9298,249,2,107.31,Allana Macedo,1,1,1,3,Inativo
9299,64,4,5081.82,Leandro da Mota,2,2,3,7,Regular
9300,21,3,1452.25,Alice Ribeiro,3,1,1,5,Ocasional
9301,177,1,1242.26,Marcela Pinto,1,1,1,3,Inativo
9302,46,4,4709.67,Henrique Pereira,2,2,3,7,Regular
9303,52,4,11196.5,Alice Sousa,2,2,4,8,Regular
9304,53,3,1265.72,Davi Lucas da Rosa,2,1,1,4,Ocasional
9305,78,4,5049.51,Sofia Lopes,2,2,3,7,Regular
9306,24,5,4541.8099999999995,Mirella Macedo,3,3,3,9,Regular
9307,182,3,2852.44,Maria Vitória Azevedo,1,1,2,4,Ocasional
9308,14,6,7230.5599999999995,Caio Almeida,4,3,3,10,VIP
9309,108,6,8003.61,Sra. Pietra Sá,1,3,4,8,Regular
9310,235,1,108.6,Luiza Pastor,1,1,1,3,Inativo
9311,3,1,56.64,Maria Liz da Mota,4,1,1,6,Ocasional
9312,45,10,10537.07,Srta. Ana Cecília Cassiano,2,4,4,10,VIP
9313,2,4,5567.960000000001,Kevin Marques,4,2,3,9,Regular
9314,3,8,15333.14,Bárbara Cavalcante,4,4,4,12,VIP
9315,27,4,2316.95,Srta. Agatha Andrade,3,2,2,7,Regular
9316,270,2,505.17,Ana Lívia da Conceição,1,1,1,3,Inativo
9317,27,3,4436.51,Raquel Silveira,3,1,3,7,Regular
9318,9,6,2402.85,Dr. Liam Sampaio,4,3,2,9,Regular
9319,135,4,3410.92,João Felipe Cavalcanti,1,2,2,5,Ocasional
9320,66,4,1298.16,Joaquim Pinto,2,2,1,5,Ocasional
9321,250,2,207.98000000000002,Allana da Mota,1,1,1,3,Inativo
9322,71,4,4794.599999999999,Enrico Sousa,2,2,3,7,Regular
9323,54,5,2802.02,Maria Flor da Mota,2,3,2,7,Regular
9324,20,5,5083.75,Luna Vargas,3,3,3,9,Regular
9325,49,4,5185.88,Theo Porto,2,2,3,7,Regular
9326,17,7,8841.65,Sra. Julia Marques,4,4,4,12,VIP
9327,33,3,3697.45,João Gabriel Monteiro,3,1,2,6,Ocasional
9328,18,2,1064.33,Maria Julia Barbosa,4,1,1,6,Ocasional
9329,21,4,4779.45,Dra. Camila da Cunha,3,2,3,8,Regular
9330,35,3,8909.55,Emanuella da Cunha,3,1,4,8,Regular
9331,147,4,3541.3,Marcela Fogaça,1,2,2,5,Ocasional
9332,45,4,3307.75,Gabrielly da Paz,2,2,2,6,Ocasional
9333,54,6,8689.63,Mariana Araújo,2,3,4,9,Regular
9334,35,2,3428.5699999999997,Matheus Pires,3,1,2,6,Ocasional
9335,140,4,6567.47,José da Cruz,1,2,3,6,Ocasional
9336,24,7,13612.85,Sophie Gomes,3,4,4,11,VIP
9337,23,3,5764.42,Guilherme Aparecida,3,1,3,7,Regular
9338,44,5,9121.59,Bento Silva,2,3,4,9,Regular
9339,34,4,3414.17,Liam Gonçalves,3,2,2,7,Regular
9340,50,7,7996.0599999999995,Sr. Vitor Hugo Nunes,2,4,4,10,VIP
9341,112,3,1269.0,Maria Isis Câmara,1,1,1,3,Inativo
9342,126,2,2506.3599999999997,Dra. Ana Liz Jesus,1,1,2,4,Ocasional
9343,15,6,2988.19,Catarina Pastor,4,3,2,9,Regular
9344,117,3,8441.42,Kaique Andrade,1,1,4,6,Ocasional
9345,18,4,2528.87,Amanda Garcia,4,2,2,8,Regular
9346,12,7,7330.86,Ravi Vargas,4,4,4,12,VIP
9347,4,2,5001.719999999999,Miguel Cardoso,4,1,3,8,Regular
9348,15,6,5646.89,Dra. Maria Isis Barros,4,3,3,10,VIP
9349,4,4,1935.6100000000001,Dr. João Lucas Cardoso,4,2,1,7,Regular
9350,4,5,5821.76,Sr. Brayan Garcia,4,3,3,10,VIP
9351,65,5,5356.55,Sr. João Garcia,2,3,3,8,Regular
9352,129,4,5626.8099999999995,Thales Camargo,1,2,3,6,Ocasional
9354,195,3,1185.08,José Miguel Siqueira,1,1,1,3,Inativo
9355,73,3,2844.72,Sra. Maria Aparecida,2,1,2,5,Ocasional
9356,134,6,12320.039999999999,Carolina da Costa,1,3,4,8,Regular
9357,47,7,6597.75,Maria Luiza da Conceição,2,4,3,9,Regular
9358,49,6,5797.41,Maria Isis Cassiano,2,3,3,8,Regular
9359,86,6,2323.83,Nina Ramos,2,3,2,7,Regular
9360,8,9,13867.18,Dr. Francisco Oliveira,4,4,4,12,VIP
9361,11,1,479.68,Eloá Souza,4,1,1,6,Ocasional
9362,62,5,2798.35,Manuela Carvalho,2,3,2,7,Regular
9363,90,2,2878.04,Bruna da Costa,1,1,2,4,Ocasional
9364,5,6,4846.98,Isaque Duarte,4,3,3,10,VIP
9365,120,5,5164.74,João Miguel Novais,1,3,3,7,Regular
9366,13,7,2591.93,Pietra Sá,4,4,2,10,VIP
9367,57,7,6155.83,Srta. Juliana Andrade,2,4,3,9,Regular
9368,15,3,2717.91,Giovanna Cirino,4,1,2,7,Regular
9369,33,9,14063.439999999999,Maria Alice Souza,3,4,4,11,VIP
9370,22,5,3209.68,Maria Vitória Rezende,3,3,2,8,Regular
9371,1,4,8825.77,Pedro Miguel Souza,4,2,4,10,VIP
9372,4,1,293.0,Sophie Aragão,4,1,1,6,Ocasional
9373,17,4,1372.35,Maria Isis Moraes,4,2,1,7,Regular
9374,56,3,4713.62,Bella Ramos,2,1,3,6,Ocasional
9375,11,2,2658.59,Ísis Vieira,4,1,2,7,Regular
9377,2,12,23812.32,Benjamin Sá,4,4,4,12,VIP
9378,221,3,7079.62,Ana Clara Siqueira,1,1,3,5,Ocasional
9379,31,3,8262.880000000001,Rafael Nogueira,3,1,4,8,Regular
9380,104,2,987.6899999999999,Melissa Costela,1,1,1,3,Inativo
9381,10,5,4648.6,Théo Vasconcelos,4,3,3,10,VIP
9382,36,5,5745.360000000001,Ana Carolina Sá,3,3,3,9,Regular
9383,1,9,9909.96,Srta. Helena Campos,4,4,4,12,VIP
9384,23,6,7706.58,Dra. Melina Ferreira,3,3,4,10,VIP
9385,39,4,2368.8,João Felipe Ferreira,3,2,2,7,Regular
9386,10,7,3923.43,Lívia da Cunha,4,4,2,10,VIP
9387,33,5,2352.63,Luísa Pimenta,3,3,2,8,Regular
9388,13,6,8361.83,Ana Laura Castro,4,3,4,11,VIP
9389,171,3,2750.3599999999997,Pedro Lucas Novaes,1,1,2,4,Ocasional
9390,168,3,4914.91,Vicente Pires,1,1,3,5,Ocasional
9391,63,6,2580.66,João Vitor Ferreira,2,3,2,7,Regular
9392,13,7,6857.56,Sra. Sarah Rocha,4,4,3,11,VIP
9393,34,3,1190.21,Maria Sophia Jesus,3,1,1,5,Ocasional
9394,37,9,19247.75,Giovanna Alves,3,4,4,11,VIP
9395,52,6,7769.120000000001,Heloisa Pimenta,2,3,4,9,Regular
9396,8,4,4694.56,Vicente Correia,4,2,3,9,Regular
9397,24,7,6135.33,Lunna Borges,3,4,3,10,VIP
9398,5,2,177.32999999999998,Isis Jesus,4,1,1,6,Ocasional
9399,11,5,3332.45,Srta. Maria Alice Cavalcante,4,3,2,9,Regular
9400,44,5,2525.05,Luiz Miguel Cassiano,2,3,2,7,Regular
9401,54,6,2143.7,Nathan Lopes,2,3,1,6,Ocasional
9402,140,2,2484.76,Dra. Caroline Gonçalves,1,1,2,4,Ocasional
9403,115,4,14035.71,Renan Montenegro,1,2,4,7,Regular
9404,33,5,8162.360000000001,Guilherme Carvalho,3,3,4,10,VIP
9405,6,5,11387.689999999999,Aylla Borges,4,3,4,11,VIP
9406,17,3,3179.05,Pedro Vasconcelos,4,1,2,7,Regular
9407,17,5,7051.7,Yago Cavalcante,4,3,3,10,VIP
9408,16,5,3705.75,Maysa Novaes,4,3,2,9,Regular
9409,72,5,9928.29,Beatriz das Neves,2,3,4,9,Regular
9410,71,5,4580.04,Marcela Siqueira,2,3,3,8,Regular
9411,89,3,2934.69,Ryan da Costa,1,1,2,4,Ocasional
9412,64,7,13042.92,Aylla Camargo,2,4,4,10,VIP
9413,2,6,6148.77,Kamilly Vargas,4,3,3,10,VIP
9414,15,4,9383.96,Maria Liz Lopes,4,2,4,10,VIP
9415,19,3,1723.1200000000001,Luiz Miguel Nascimento,4,1,1,6,Ocasional
9416,7,8,7496.13,Sra. Maria Clara da Rosa,4,4,4,12,VIP
9417,11,1,1777.78,Sra. Clara Alves,4,1,1,6,Ocasional
9418,78,2,728.2199999999999,Kevin Moraes,2,1,1,4,Ocasional
9419,51,3,3183.3199999999997,Dra. Sophia Correia,2,1,2,5,Ocasional
9420,120,2,462.39,Caio Carvalho,1,1,1,3,Inativo
9421,17,4,2541.16,Thiago Moura,4,2,2,8,Regular
9422,60,4,4231.96,Igor Ferreira,2,2,2,6,Ocasional
9423,16,3,644.58,Maria Luiza Câmara,4,1,1,6,Ocasional
9424,27,4,4811.89,Maria Luiza da Costa,3,2,3,8,Regular
9425,43,10,20172.8,Benjamim da Cruz,3,4,4,11,VIP
9426,8,5,3146.98,Oliver Melo,4,3,2,9,Regular
9427,17,6,3830.84,Srta. Maya Pinto,4,3,2,9,Regular
9428,72,5,13037.669999999998,Ester Aragão,2,3,4,9,Regular
9429,68,6,3392.3999999999996,Heitor Ribeiro,2,3,2,7,Regular
9430,37,7,6626.79,Ana Julia Novais,3,4,3,10,VIP
9431,37,5,2697.9,Dante Oliveira,3,3,2,8,Regular
9432,33,5,13940.49,Vitor Hugo Correia,3,3,4,10,VIP
9434,12,4,6195.14,Luara Pereira,4,2,3,9,Regular
9435,4,2,883.29,Joaquim Novais,4,1,1,6,Ocasional
9436,13,3,3118.34,João Gabriel Sousa,4,1,2,7,Regular
9437,189,1,2883.58,Beatriz Viana,1,1,2,4,Ocasional
9438,33,3,1640.31,Arthur Miguel Marques,3,1,1,5,Ocasional
9439,115,3,1129.73,Samuel Rios,1,1,1,3,Inativo
9440,63,4,10507.06,Sarah Machado,2,2,4,8,Regular
9441,51,7,10805.69,Dra. Emilly Cavalcanti,2,4,4,10,VIP
9442,34,5,8702.32,Thales Cavalcante,3,3,4,10,VIP
9443,21,2,2826.42,Sr. Josué Jesus,3,1,2,6,Ocasional
9444,5,4,3087.0699999999997,Gustavo Henrique da Conceição,4,2,2,8,Regular
9445,40,4,6568.76,Brenda Cavalcante,3,2,3,8,Regular
9447,1,8,9570.9,Yago Sales,4,4,4,12,VIP
9448,13,7,8041.57,Juliana Monteiro,4,4,4,12,VIP
9449,115,6,14037.04,Valentim Azevedo,1,3,4,8,Regular
9450,13,5,10843.33,Srta. Luísa Jesus,4,3,4,11,VIP
9451,6,7,2600.88,Diogo Pimenta,4,4,2,10,VIP
9452,6,8,3892.26,Anthony Gabriel Azevedo,4,4,2,10,VIP
9453,14,3,1961.03,Sabrina Machado,4,1,1,6,Ocasional
9454,56,3,4368.450000000001,Antonella Cardoso,2,1,2,5,Ocasional
9455,15,2,2889.9100000000003,Heitor Rocha,4,1,2,7,Regular
9456,21,5,7369.85,Bento Vieira,3,3,4,10,VIP
9457,15,6,9002.06,Gabriela Caldeira,4,3,4,11,VIP
9458,65,4,6198.23,Anthony Rezende,2,2,3,7,Regular
9459,16,3,2804.55,Arthur Cunha,4,1,2,7,Regular
9460,123,1,163.83,Nicole Cirino,1,1,1,3,Inativo
9461,27,4,3878.82,Dom Mendonça,3,2,2,7,Regular
9462,22,1,330.45,Joana Martins,3,1,1,5,Ocasional
9463,95,3,4687.08,Pedro Henrique Peixoto,1,1,3,5,Ocasional
9464,13,2,2993.33,Stephany Barros,4,1,2,7,Regular
9465,20,2,516.27,Srta. Giovanna Macedo,3,1,1,5,Ocasional
9466,127,1,838.67,Lorenzo Vieira,1,1,1,3,Inativo
9467,198,2,223.25,Valentim Costa,1,1,1,3,Inativo
9468,56,9,10463.51,Agatha Moraes,2,4,4,10,VIP
9469,7,7,6753.7699999999995,Srta. Mariana Aragão,4,4,3,11,VIP
9470,124,9,15459.130000000001,Júlia Porto,1,4,4,9,Regular
9471,267,2,1327.22,Dra. Isabela Rezende,1,1,1,3,Inativo
9472,16,4,3980.45,Breno Campos,4,2,2,8,Regular
9473,15,6,10638.23,Stella da Costa,4,3,4,11,VIP
9474,2,10,15894.23,Luiz Henrique Ribeiro,4,4,4,12,VIP
9475,72,3,3554.27,Otto Barbosa,2,1,2,5,Ocasional
9476,22,2,1190.79,Mariane Carvalho,3,1,1,5,Ocasional
9477,58,6,2697.74,Enzo Gabriel Jesus,2,3,2,7,Regular
9478,4,5,4229.28,Gustavo Henrique da Rocha,4,3,2,9,Regular
9479,44,5,5532.360000000001,Jade Dias,2,3,3,8,Regular
9480,109,4,2989.7200000000003,Lunna Cavalcante,1,2,2,5,Ocasional
9481,86,4,4692.84,Antonella Fonseca,2,2,3,7,Regular
9482,1,7,3710.38,Luara Mendonça,4,4,2,10,VIP
9483,364,1,1096.98,Danilo Vasconcelos,1,1,1,3,Inativo
9484,168,1,510.45,Gustavo Henrique Vasconcelos,1,1,1,3,Inativo
9485,35,2,5324.77,Gabrielly Borges,3,1,3,7,Regular
9486,17,8,9864.6,Kamilly Fonseca,4,4,4,12,VIP
9487,57,9,10943.199999999999,Alexia da Cunha,2,4,4,10,VIP
9488,52,4,4033.58,Sr. Luiz Miguel Garcia,2,2,2,6,Ocasional
9489,85,3,4044.38,Eduardo Moreira,2,1,2,5,Ocasional
9490,2,2,339.99,Maria Helena Jesus,4,1,1,6,Ocasional
9491,70,5,2699.48,Ravi Lucca Duarte,2,3,2,7,Regular
9492,25,3,1773.82,Rafael Azevedo,3,1,1,5,Ocasional
9493,139,2,5471.73,Cecilia Mendes,1,1,3,5,Ocasional
9494,29,3,1987.5100000000002,Maria Liz Pastor,3,1,1,5,Ocasional
9495,60,5,9470.01,Srta. Isabelly Campos,2,3,4,9,Regular
9496,60,6,7268.03,Elisa Lopes,2,3,3,8,Regular
9497,10,4,9331.86,Alice Moura,4,2,4,10,VIP
9498,68,2,1011.48,Dr. Isaac da Conceição,2,1,1,4,Ocasional
9499,204,4,7118.92,Joana Barbosa,1,2,3,6,Ocasional
9500,248,2,1062.26,Gael Henrique Alves,1,1,1,3,Inativo
9501,25,2,4722.16,Dr. Leonardo Sales,3,1,3,7,Regular
9502,17,8,3348.04,Sra. Marcela Carvalho,4,4,2,10,VIP
9503,49,6,5973.08,Arthur Martins,2,3,3,8,Regular
9504,146,3,3316.3,Alana Caldeira,1,1,2,4,Ocasional
9505,226,2,4481.65,Diego da Mata,1,1,3,5,Ocasional
9506,43,6,3852.74,Antônio Silva,3,3,2,8,Regular
9507,28,6,6361.64,Dra. Ester Pastor,3,3,3,9,Regular
9508,48,9,18593.19,Ana Beatriz Costela,2,4,4,10,VIP
9509,103,4,1741.8,Brayan Correia,1,2,1,4,Ocasional
9510,17,5,4095.4700000000003,Ravy Rezende,4,3,2,9,Regular
9511,3,5,10213.49,Maria Eduarda Freitas,4,3,4,11,VIP
9512,34,6,5193.92,Theodoro Ramos,3,3,3,9,Regular
9513,25,2,3022.76,Sarah Mendonça,3,1,2,6,Ocasional
9514,36,6,5689.41,Antony Marques,3,3,3,9,Regular
9515,1,8,17251.84,Ayla da Rosa,4,4,4,12,VIP
9516,51,3,1528.82,Srta. Anna Liz Fernandes,2,1,1,4,Ocasional
9517,13,4,3903.51,Luiza Cunha,4,2,2,8,Regular
9518,37,4,4902.31,Dra. Isabela Ribeiro,3,2,3,8,Regular
9519,6,3,6530.51,Dr. Rael Pereira,4,1,3,8,Regular
9520,190,1,437.74,Luara Ramos,1,1,1,3,Inativo
9521,20,4,2227.65,Júlia Jesus,3,2,1,6,Ocasional
9522,74,3,4578.5,João Felipe Novais,2,1,3,6,Ocasional
9524,30,4,1591.88,Dra. Anna Liz Pastor,3,2,1,6,Ocasional
9525,302,3,2080.54,Hadassa Mendes,1,1,1,3,Inativo
9526,45,4,2863.81,Maria Clara Alves,2,2,2,6,Ocasional
9527,28,4,3706.16,Sr. Murilo Barbosa,3,2,2,7,Regular
9528,279,2,925.78,Henry Pires,1,1,1,3,Inativo
9529,36,4,3212.69,Srta. Sophie da Cruz,3,2,2,7,Regular
9530,71,4,5320.389999999999,Rebeca Oliveira,2,2,3,7,Regular
9531,6,6,11116.11,Vitor Hugo da Rocha,4,3,4,11,VIP
9532,131,2,656.44,Joaquim Pinto,1,1,1,3,Inativo
9533,9,5,5446.42,Liam da Rosa,4,3,3,10,VIP
9534,28,5,7347.94,Cecilia Costela,3,3,4,10,VIP
9535,15,7,10597.81,Jade Peixoto,4,4,4,12,VIP
9536,106,4,1187.2,Sra. Ana Carolina Brito,1,2,1,4,Ocasional
9537,96,3,2926.84,Amanda Farias,1,1,2,4,Ocasional
9538,34,3,2039.85,Isabel Duarte,3,1,1,5,Ocasional
9539,3,7,9352.48,Maria Oliveira,4,4,4,12,VIP
9540,55,4,275.33000000000004,Ana Júlia Sousa,2,2,1,5,Ocasional
9541,61,5,7524.38,Joana Aragão,2,3,4,9,Regular
9542,4,6,8916.22,Sr. Arthur Campos,4,3,4,11,VIP
9543,17,4,10048.119999999999,Ravy Aparecida,4,2,4,10,VIP
9544,1,2,1195.77,Maria Julia Barros,4,1,1,6,Ocasional
9545,42,6,10434.689999999999,Fernanda Oliveira,3,3,4,10,VIP
9546,85,6,4304.7,Luiza Camargo,2,3,2,7,Regular
9547,35,6,7795.25,Gustavo Garcia,3,3,4,10,VIP
9548,66,4,1447.1399999999999,Dr. Diego Duarte,2,2,1,5,Ocasional
9549,18,4,1945.46,Bryan Duarte,4,2,1,7,Regular
9550,11,9,10051.56,Ryan Câmara,4,4,4,12,VIP
9551,20,5,5377.5599999999995,Bruno Oliveira,3,3,3,9,Regular
9552,51,3,832.55,Maria Clara Montenegro,2,1,1,4,Ocasional
9553,112,2,6651.150000000001,Enzo Nunes,1,1,3,5,Ocasional
9554,10,7,11246.900000000001,Thomas Fonseca,4,4,4,12,VIP
9555,42,4,4581.54,Sra. Maria Helena Jesus,3,2,3,8,Regular
9556,1,3,849.5699999999999,Natália Cassiano,4,1,1,6,Ocasional
9557,101,4,2875.62,Cauã Farias,1,2,2,5,Ocasional
9558,117,4,4453.77,Dr. Theodoro da Luz,1,2,3,6,Ocasional
9559,105,4,2176.96,Enrico Ramos,1,2,1,4,Ocasional
9560,57,5,4447.25,Dr. Valentim da Cruz,2,3,3,8,Regular
9561,167,4,8472.32,Isadora Cirino,1,2,4,7,Regular
9562,4,5,10877.66,Sr. Ravi Lucca Sousa,4,3,4,11,VIP
9563,28,3,4660.2,Maria Sophia Silva,3,1,3,7,Regular
9564,40,9,12228.099999999999,Clara Pires,3,4,4,11,VIP
9565,131,5,6417.2300000000005,Apollo Ribeiro,1,3,3,7,Regular
9567,98,9,16905.3,Luiz Miguel Pimenta,1,4,4,9,Regular
9568,14,8,7531.54,Hadassa Oliveira,4,4,4,12,VIP
9569,12,9,12119.41,Fernanda Campos,4,4,4,12,VIP
9570,105,1,1980.73,Sr. Josué Nunes,1,1,1,3,Inativo
9571,14,7,6787.37,Sr. Isaac Mendes,4,4,3,11,VIP
9572,19,6,8107.89,Rebeca Cardoso,4,3,4,11,VIP
9573,121,2,2962.1,Bryan Azevedo,1,1,2,4,Ocasional
9575,7,6,4506.969999999999,Otto Caldeira,4,3,3,10,VIP
9576,8,2,1294.0700000000002,Bianca Gomes,4,1,1,6,Ocasional
9577,243,1,643.26,Dr. Vinicius Camargo,1,1,1,3,Inativo
9578,36,5,1474.4,Beatriz Carvalho,3,3,1,7,Regular
9579,54,3,8393.53,Levi Novaes,2,1,4,7,Regular
9580,15,5,2145.85,Vitor Gabriel Viana,4,3,1,8,Regular
9581,5,5,6171.2,Ravi Lucca Freitas,4,3,3,10,VIP
9582,41,6,5991.93,Anthony Gabriel Fogaça,3,3,3,9,Regular
9583,59,4,3767.5899999999997,Lucas Gabriel Teixeira,2,2,2,6,Ocasional
9584,65,6,6177.5,Matheus Monteiro,2,3,3,8,Regular
9585,5,5,3476.86,Bella Alves,4,3,2,9,Regular
9586,7,3,13134.65,Sr. Miguel Cavalcanti,4,1,4,9,Regular
9587,40,5,6400.889999999999,Benício Guerra,3,3,3,9,Regular
9588,45,9,14271.19,Davi Pires,2,4,4,10,VIP
9589,35,3,7216.639999999999,Dr. Nicolas Correia,3,1,3,7,Regular
9590,72,3,1170.3600000000001,Mariane Sousa,2,1,1,4,Ocasional
9591,39,5,4180.32,Maria Helena Rocha,3,3,2,8,Regular
9592,13,8,11822.75,Mateus Barros,4,4,4,12,VIP
9593,107,3,1183.24,Antônio Azevedo,1,1,1,3,Inativo
9594,61,2,2173.2099999999996,Arthur Gabriel Casa Grande,2,1,1,4,Ocasional
9595,57,8,6279.75,Manuella Aragão,2,4,3,9,Regular
9596,224,2,124.29,Sra. Bárbara Cassiano,1,1,1,3,Inativo
9597,21,4,6581.37,Rodrigo Barros,3,2,3,8,Regular
9598,51,3,2122.93,Bárbara Carvalho,2,1,1,4,Ocasional
9599,49,9,5942.12,Sra. Ana Sophia Leão,2,4,3,9,Regular
9600,19,3,3449.71,Nina Sousa,4,1,2,7,Regular
9601,12,2,999.02,Maria Flor Barbosa,4,1,1,6,Ocasional
9602,19,3,3552.98,Ágatha Vasconcelos,4,1,2,7,Regular
9603,12,3,1122.93,Pietra Cunha,4,1,1,6,Ocasional
9604,13,5,10314.31,Davi Mendes,4,3,4,11,VIP
9605,34,5,3305.21,Vitor Hugo Montenegro,3,3,2,8,Regular
9606,225,3,1614.0900000000001,Elisa Jesus,1,1,1,3,Inativo
9607,11,6,4674.969999999999,Danilo Albuquerque,4,3,3,10,VIP
9608,114,2,700.93,Dr. Kaique Moraes,1,1,1,3,Inativo
9609,23,4,3763.16,Augusto Fernandes,3,2,2,7,Regular
9610,15,6,17799.37,Gustavo Henrique da Paz,4,3,4,11,VIP
9611,14,5,3980.1,Enzo Gabriel Câmara,4,3,2,9,Regular
9612,282,1,2279.39,Enrico Sousa,1,1,2,4,Ocasional
9613,290,2,3226.82,Pedro Henrique Rezende,1,1,2,4,Ocasional
9614,16,7,3807.85,Guilherme Leão,4,4,2,10,VIP
9615,47,6,8340.109999999999,Kamilly Sales,2,3,4,9,Regular
9616,23,7,7136.59,Dr. Caio Câmara,3,4,3,10,VIP
9617,88,5,9915.5,Arthur Gabriel Siqueira,1,3,4,8,Regular
9618,104,3,2696.63,Sr. Gabriel Brito,1,1,2,4,Ocasional
9619,11,3,1024.96,Raquel Novais,4,1,1,6,Ocasional
9620,53,2,635.25,Sofia da Luz,2,1,1,4,Ocasional
9621,57,1,606.37,João Lucas da Cunha,2,1,1,4,Ocasional
9622,83,6,14458.95,Maria Luiza Leão,2,3,4,9,Regular
9623,11,5,1685.3899999999999,Luana Sá,4,3,1,8,Regular
9624,332,1,641.92,Sabrina Rodrigues,1,1,1,3,Inativo
9625,6,7,4714.61,Mateus Teixeira,4,4,3,11,VIP
9626,94,1,280.26,Sr. João Pedro Sousa,1,1,1,3,Inativo
9627,30,8,9126.36,Matteo Gomes,3,4,4,11,VIP
9628,26,6,4571.41,Leandro Correia,3,3,3,9,Regular
9629,182,1,4736.63,Sra. Joana Carvalho,1,1,3,5,Ocasional
9630,51,5,4584.43,Sabrina Almeida,2,3,3,8,Regular
9631,83,4,1596.5300000000002,Mirella Aparecida,2,2,1,5,Ocasional
9632,3,2,3278.31,Valentim Castro,4,1,2,7,Regular
9633,234,2,924.26,Luiz Felipe Pastor,1,1,1,3,Inativo
9634,208,4,9621.18,Maria Vitória da Mata,1,2,4,7,Regular
9635,145,4,3545.92,Ian Correia,1,2,2,5,Ocasional
9636,6,4,2755.99,Bella Viana,4,2,2,8,Regular
9637,91,6,4057.32,Isabella Araújo,1,3,2,6,Ocasional
9638,2,8,7274.75,Henry Gabriel Rezende,4,4,3,11,VIP
9639,136,1,7844.26,Júlia Barros,1,1,4,6,Ocasional
9640,1,6,5998.219999999999,Maria Fernanda Oliveira,4,3,3,10,VIP
9641,71,4,1387.73,Sr. Gael Henrique Montenegro,2,2,1,5,Ocasional
9642,358,1,613.58,Joana Cavalcante,1,1,1,3,Inativo
9643,9,5,4468.99,João Moreira,4,3,3,10,VIP
9644,47,4,4976.76,Srta. Caroline da Paz,2,2,3,7,Regular
9645,187,3,729.0899999999999,Maitê Sales,1,1,1,3,Inativo
9646,8,4,1216.6100000000001,José Pimenta,4,2,1,7,Regular
9647,36,4,8600.179999999998,Davi Luiz Novais,3,2,4,9,Regular
9648,91,7,8078.879999999999,Caroline da Mota,1,4,4,9,Regular
9649,159,3,707.27,Heloísa Abreu,1,1,1,3,Inativo
9650,71,3,3091.58,Kevin Siqueira,2,1,2,5,Ocasional
9651,78,2,312.01,Kaique Araújo,2,1,1,4,Ocasional
9652,178,3,4205.950000000001,Matteo Andrade,1,1,2,4,Ocasional
9653,121,8,15750.2,Gustavo Henrique Farias,1,4,4,9,Regular
9654,9,5,2804.81,Dante Martins,4,3,2,9,Regular
9655,33,3,4532.0,Srta. Isadora Sampaio,3,1,3,7,Regular
9656,14,2,3069.14,Allana Santos,4,1,2,7,Regular
9657,50,4,5801.93,Yasmin Pires,2,2,3,7,Regular
9658,7,5,11238.82,Maria Eduarda Pastor,4,3,4,11,VIP
9659,2,8,7426.33,Sra. Isabel Novaes,4,4,4,12,VIP
9660,1,7,7979.96,Emanuel Gonçalves,4,4,4,12,VIP
9661,35,3,6011.349999999999,Maria Helena Barbosa,3,1,3,7,Regular
9662,42,2,876.0,João Vitor da Costa,3,1,1,5,Ocasional
9663,3,6,10042.84,Pietra Cassiano,4,3,4,11,VIP
9664,39,2,464.01,Emanuel Cavalcante,3,1,1,5,Ocasional
9665,8,12,18156.39,Hellena Câmara,4,4,4,12,VIP
9666,10,8,7250.75,João Lucas Pires,4,4,3,11,VIP
9667,159,3,2487.8999999999996,Dra. Cecília da Mota,1,1,2,4,Ocasional
9668,136,5,5962.9,Luana Sousa,1,3,3,7,Regular
9669,9,7,9060.67,Gael Henrique Barbosa,4,4,4,12,VIP
9670,27,6,7088.24,Gabrielly Camargo,3,3,3,9,Regular
9671,3,5,9305.14,Heitor Mendes,4,3,4,11,VIP
9672,27,7,5192.03,Marina Casa Grande,3,4,3,10,VIP
9673,39,7,3301.76,Brayan Cavalcante,3,4,2,9,Regular
9674,16,4,1856.6200000000001,Sabrina Novaes,4,2,1,7,Regular
9675,18,7,3235.0,Yasmin Vasconcelos,4,4,2,10,VIP
9676,192,3,13340.93,Léo Rocha,1,1,4,6,Ocasional
9677,73,4,3675.33,Sr. Vitor Hugo Vasconcelos,2,2,2,6,Ocasional
9678,16,4,10433.29,Rodrigo Vargas,4,2,4,10,VIP
9679,1,6,8104.95,Arthur Miguel Pacheco,4,3,4,11,VIP
9680,2,6,6729.9800000000005,Cauã da Costa,4,3,3,10,VIP
9681,8,1,1082.43,Clara Sá,4,1,1,6,Ocasional
9682,107,6,7565.25,Cecília Pimenta,1,3,4,8,Regular
9683,24,6,4085.49,Esther da Rocha,3,3,2,8,Regular
9684,126,6,6119.099999999999,Enzo Macedo,1,3,3,7,Regular
9685,135,3,448.52,Sr. Gael Henrique da Luz,1,1,1,3,Inativo
9686,104,4,1712.82,Srta. Juliana Teixeira,1,2,1,4,Ocasional
9687,3,4,1405.63,Caroline Araújo,4,2,1,7,Regular
9688,107,3,1246.49,Lívia Mendes,1,1,1,3,Inativo
9689,18,5,9023.3,Heloisa Vasconcelos,4,3,4,11,VIP
9690,5,7,18109.64,Marina Fogaça,4,4,4,12,VIP
9691,136,5,8054.7,Sr. Luiz Gustavo Vasconcelos,1,3,4,8,Regular
9692,163,1,653.01,Maria Brito,1,1,1,3,Inativo
9693,44,5,3793.04,Kaique Freitas,2,3,2,7,Regular
9694,18,3,973.71,Gustavo Henrique Câmara,4,1,1,6,Ocasional
9695,45,6,2604.27,Léo Casa Grande,2,3,2,7,Regular
9696,3,4,6159.42,Sra. Maria Luísa da Costa,4,2,3,9,Regular
9697,117,2,5238.28,Dr. Vitor Gabriel Fonseca,1,1,3,5,Ocasional
9698,68,10,22499.21,Ana Viana,2,4,4,10,VIP
9699,125,3,4947.86,Heloísa Pimenta,1,1,3,5,Ocasional
9700,47,5,2346.11,Ana Júlia da Rosa,2,3,2,7,Regular
9701,7,5,1752.27,Laís Vieira,4,3,1,8,Regular
9702,77,6,5187.18,Sra. Raquel Moreira,2,3,3,8,Regular
9703,162,2,2415.96,Evelyn Barbosa,1,1,2,4,Ocasional
9704,26,5,6341.12,Isaac Vargas,3,3,3,9,Regular
9705,45,5,4605.63,Dom Pinto,2,3,3,8,Regular
9706,54,6,5314.42,Helena Sá,2,3,3,8,Regular
9707,112,7,16951.09,Dra. Lorena Fonseca,1,4,4,9,Regular
9708,15,9,9758.22,Lorena da Cruz,4,4,4,12,VIP
9709,36,4,2729.23,Letícia Duarte,3,2,2,7,Regular
9710,364,1,3497.5,Bernardo Câmara,1,1,2,4,Ocasional
9711,339,1,1882.1,Laura Ferreira,1,1,1,3,Inativo
9712,118,4,2128.29,Sra. Natália Freitas,1,2,1,4,Ocasional
9713,22,2,872.72,Levi Cardoso,3,1,1,5,Ocasional
9714,37,5,14997.25,Vitor Hugo Garcia,3,3,4,10,VIP
9715,182,1,2941.99,Isis Lima,1,1,2,4,Ocasional
9716,10,6,10748.51,Isaque Silveira,4,3,4,11,VIP
9717,38,7,5727.84,Emanuel Pereira,3,4,3,10,VIP
9718,52,6,6886.11,Gabrielly Marques,2,3,3,8,Regular
9719,21,3,5378.74,Maria Alice Gonçalves,3,1,3,7,Regular
9720,97,2,4586.85,Sra. Isadora Gomes,1,1,3,5,Ocasional
9721,8,2,2277.5699999999997,Yan da Costa,4,1,2,7,Regular
9722,9,4,3789.37,Lívia Costela,4,2,2,8,Regular
9723,28,4,3436.69,Sra. Emanuelly da Costa,3,2,2,7,Regular
9724,10,5,5429.62,Milena Brito,4,3,3,10,VIP
9725,162,2,7655.48,Emilly Cirino,1,1,4,6,Ocasional
9726,154,2,1310.1399999999999,Gustavo Henrique Silveira,1,1,1,3,Inativo
9727,13,5,3539.64,Léo Sampaio,4,3,2,9,Regular
9728,130,2,236.9,José Pedro Camargo,1,1,1,3,Inativo
9729,312,1,107.37,Antony das Neves,1,1,1,3,Inativo
9730,20,7,13835.84,Rebeca Pereira,3,4,4,11,VIP
9731,46,5,10733.97,Alexia Oliveira,2,3,4,9,Regular
9732,38,2,1127.78,Olívia Fonseca,3,1,1,5,Ocasional
9733,18,5,14427.31,Ian da Conceição,4,3,4,11,VIP
9734,361,1,450.16,Benjamin Farias,1,1,1,3,Inativo
9735,1,3,3509.55,Cauê Lopes,4,1,2,7,Regular
9736,21,5,3818.15,Ana Beatriz Sales,3,3,2,8,Regular
9737,34,6,4398.91,Lívia Casa Grande,3,3,3,9,Regular
9738,9,7,6910.38,Srta. Emanuelly Azevedo,4,4,3,11,VIP
9739,49,8,13383.27,Dr. Augusto Ferreira,2,4,4,10,VIP
9740,78,4,9882.91,Dante Montenegro,2,2,4,8,Regular
9741,31,6,4121.15,Davi Miguel Albuquerque,3,3,2,8,Regular
9742,47,5,3112.7300000000005,Renan Sá,2,3,2,7,Regular
9743,5,6,13207.26,Asafe Peixoto,4,3,4,11,VIP
9744,356,1,6191.13,Sra. Sophie Leão,1,1,3,5,Ocasional
9745,43,2,4519.5199999999995,Mirella Cavalcanti,3,1,3,7,Regular
9746,25,4,2256.79,Srta. Maria Laura Pacheco,3,2,1,6,Ocasional
9747,71,7,13390.16,Valentina Andrade,2,4,4,10,VIP
9748,3,8,4677.39,Laura Barros,4,4,3,11,VIP
9749,238,2,8930.45,Alexandre Fonseca,1,1,4,6,Ocasional
9750,36,5,10564.45,Maria Laura Gonçalves,3,3,4,10,VIP
9751,71,1,171.79,Giovanna Caldeira,2,1,1,4,Ocasional
9752,31,4,3482.44,Miguel da Luz,3,2,2,7,Regular
9753,6,4,5621.46,Arthur Gabriel da Mata,4,2,3,9,Regular
9754,164,3,2349.17,Maria Liz Guerra,1,1,2,4,Ocasional
9755,39,4,6460.81,Benício Santos,3,2,3,8,Regular
9757,29,5,3091.16,Maria Liz Ribeiro,3,3,2,8,Regular
9758,13,7,11718.77,Henrique da Conceição,4,4,4,12,VIP
9759,15,3,10643.07,Lorena Araújo,4,1,4,9,Regular
9760,139,4,4744.13,Dr. Bruno Pereira,1,2,3,6,Ocasional
9761,23,5,10088.66,Luiza Camargo,3,3,4,10,VIP
9762,37,3,1201.7900000000002,Ravi Lucca Freitas,3,1,1,5,Ocasional
9763,89,3,3941.18,Asafe Macedo,1,1,2,4,Ocasional
9764,47,7,6433.25,Noah Porto,2,4,3,9,Regular
9765,70,4,5501.64,Breno Brito,2,2,3,7,Regular
9766,230,2,4772.49,Raul Silveira,1,1,3,5,Ocasional
9767,1,3,5228.42,Arthur Miguel Sales,4,1,3,8,Regular
9768,51,3,1647.4,Maria Fernanda Ferreira,2,1,1,4,Ocasional
9769,34,6,4871.98,Asafe Sousa,3,3,3,9,Regular
9770,12,4,2985.0,João Lucas Martins,4,2,2,8,Regular
9771,132,3,1456.55,Felipe Barros,1,1,1,3,Inativo
9772,13,4,7533.12,Bruna Pereira,4,2,4,10,VIP
9773,21,5,5860.29,Anthony Jesus,3,3,3,9,Regular
9774,90,6,6161.38,Srta. Maria Júlia Pinto,1,3,3,7,Regular
9775,41,3,3010.22,Arthur Souza,3,1,2,6,Ocasional
9776,298,1,2110.64,Enrico Cunha,1,1,1,3,Inativo
9777,16,6,4971.65,Raquel Sá,4,3,3,10,VIP
9778,18,5,6517.15,Alana Costela,4,3,3,10,VIP
9779,59,4,9451.95,Dra. Isabella Moraes,2,2,4,8,Regular
9780,143,4,5554.25,Zoe Azevedo,1,2,3,6,Ocasional
9781,53,4,2797.87,Ester Barbosa,2,2,2,6,Ocasional
9782,49,7,11413.689999999999,Theodoro Rios,2,4,4,10,VIP
9783,53,3,2621.75,Ísis Vieira,2,1,2,5,Ocasional
9784,20,5,5927.08,Sr. Anthony Casa Grande,3,3,3,9,Regular
9785,96,3,2217.06,Guilherme Moraes,1,1,1,3,Inativo
9786,123,6,6916.1900000000005,Bianca Teixeira,1,3,3,7,Regular
9787,120,3,10414.59,Sr. Samuel Gonçalves,1,1,4,6,Ocasional
9788,53,5,4640.530000000001,Maria Luiza Fonseca,2,3,3,8,Regular
9789,155,3,7539.13,Antony da Cruz,1,1,4,6,Ocasional
9790,115,2,2087.37,Ravi Azevedo,1,1,1,3,Inativo
9791,172,3,1595.61,Ayla Ramos,1,1,1,3,Inativo
9792,48,7,10124.89,Dr. Luiz Otávio Correia,2,4,4,10,VIP
9793,268,2,1453.19,Matteo Farias,1,1,1,3,Inativo
9794,33,6,8467.44,Rebeca Viana,3,3,4,10,VIP
9795,9,5,12638.33,João Miguel Pereira,4,3,4,11,VIP
9796,48,5,4791.33,João Felipe Montenegro,2,3,3,8,Regular
9797,5,6,8256.86,Mathias Guerra,4,3,4,11,VIP
9798,26,2,4795.45,Melina Teixeira,3,1,3,7,Regular
9799,43,5,8481.439999999999,Matheus Montenegro,3,3,4,10,VIP
9800,84,5,3254.13,Dr. Emanuel Andrade,2,3,2,7,Regular
9801,101,2,1364.0500000000002,Ian da Cruz,1,1,1,3,Inativo
9802,1,4,3433.88,Gustavo da Costa,4,2,2,8,Regular
9803,178,3,3046.37,Zoe Mendonça,1,1,2,4,Ocasional
9804,71,4,2674.7000000000003,Theo Borges,2,2,2,6,Ocasional
9805,150,4,2535.1800000000003,Bianca Barros,1,2,2,5,Ocasional
9806,68,3,2286.01,Kevin Aparecida,2,1,2,5,Ocasional
9807,5,3,2477.88,Dra. Gabrielly Oliveira,4,1,2,7,Regular
9808,159,3,2911.9700000000003,Antony Martins,1,1,2,4,Ocasional
9809,23,3,1529.86,Isaac Moura,3,1,1,5,Ocasional
9810,63,2,1417.26,João Pedro Ramos,2,1,1,4,Ocasional
9811,23,3,4889.0,Otávio Lima,3,1,3,7,Regular
9812,7,6,5403.15,Maria Isis Macedo,4,3,3,10,VIP
9813,60,3,3825.0899999999997,Henrique Garcia,2,1,2,5,Ocasional
9814,33,3,1435.75,Mariana Mendes,3,1,1,5,Ocasional
9815,12,5,4205.05,Sophie Castro,4,3,2,9,Regular
9816,63,5,13038.64,Sr. Pedro Miguel Marques,2,3,4,9,Regular
9817,19,6,1891.04,Clarice da Costa,4,3,1,8,Regular
9818,39,3,13423.93,Henry Ferreira,3,1,4,8,Regular
9819,40,3,1826.01,Dra. Olívia Novais,3,1,1,5,Ocasional
9820,61,5,6135.84,Luara Cavalcanti,2,3,3,8,Regular
9821,1,6,3070.63,Maria Sophia da Costa,4,3,2,9,Regular
9822,34,7,12767.93,Manuela Siqueira,3,4,4,11,VIP
9823,22,5,13314.42,Vitor Azevedo,3,3,4,10,VIP
9824,34,8,15974.259999999998,Caroline Mendes,3,4,4,11,VIP
9825,12,6,7688.009999999999,Maitê Gomes,4,3,4,11,VIP
9826,15,12,15023.22,Mariane Carvalho,4,4,4,12,VIP
9827,68,4,4789.29,Maria Luiza Andrade,2,2,3,7,Regular
9828,38,2,3722.76,Sr. Josué Porto,3,1,2,6,Ocasional
9829,26,4,8449.29,Aurora Lopes,3,2,4,9,Regular
9830,44,3,12624.68,Luigi Ribeiro,2,1,4,7,Regular
9831,97,5,8072.139999999999,Esther Nascimento,1,3,4,8,Regular
9832,87,7,10454.93,Bárbara Garcia,2,4,4,10,VIP
9833,49,8,7892.64,Bryan Fogaça,2,4,4,10,VIP
9834,194,3,5476.66,Vinícius Pires,1,1,3,5,Ocasional
9835,14,2,1236.84,Yan Machado,4,1,1,6,Ocasional
9836,13,3,6597.799999999999,Asafe Vieira,4,1,3,8,Regular
9837,37,4,3680.23,Maria Isis Freitas,3,2,2,7,Regular
9838,8,5,9387.289999999999,Rhavi da Mota,4,3,4,11,VIP
9839,259,2,1380.25,Joana Mendes,1,1,1,3,Inativo
9840,39,4,5615.46,Sr. Ravi Sousa,3,2,3,8,Regular
9841,42,7,10355.18,Ravi Lucca Vargas,3,4,4,11,VIP
9842,42,3,4616.2,Arthur Barros,3,1,3,7,Regular
9843,195,2,3009.65,Mariane Alves,1,1,2,4,Ocasional
9844,1,4,7387.12,Luna da Paz,4,2,4,10,VIP
9845,247,1,493.82,Emanuel Teixeira,1,1,1,3,Inativo
9846,8,6,19101.99,Thomas Cirino,4,3,4,11,VIP
9847,44,2,861.6800000000001,Alana Caldeira,2,1,1,4,Ocasional
9848,75,6,5757.98,Sra. Ana Liz Cunha,2,3,3,8,Regular
9849,163,4,2753.57,Srta. Sara da Cruz,1,2,2,5,Ocasional
9850,2,4,3740.37,Dra. Manuela Vargas,4,2,2,8,Regular
9851,10,2,4254.25,João Vitor Barbosa,4,1,2,7,Regular
9852,17,3,1828.08,Gabriela Fogaça,4,1,1,6,Ocasional
9853,37,3,1038.99,Luiz Gustavo Cunha,3,1,1,5,Ocasional
9854,31,10,12746.01,Liz da Costa,3,4,4,11,VIP
9855,57,4,2370.7,Gael Marques,2,2,2,6,Ocasional
9856,115,4,14414.96,Paulo Gonçalves,1,2,4,7,Regular
9857,188,7,5963.72,Diogo da Cunha,1,4,3,8,Regular
9858,54,6,7715.46,Letícia Pires,2,3,4,9,Regular
9859,108,3,7229.57,Diogo Fogaça,1,1,3,5,Ocasional
9860,95,5,3058.87,Bruna Fogaça,1,3,2,6,Ocasional
9861,69,5,7082.65,Brayan da Luz,2,3,3,8,Regular
9862,14,6,9528.93,Bernardo Martins,4,3,4,11,VIP
9863,37,4,8219.14,Raquel Nascimento,3,2,4,9,Regular
9864,59,3,2967.4,Luara Vieira,2,1,2,5,Ocasional
9865,21,11,20811.11,Yuri Costela,3,4,4,11,VIP
9866,48,4,6690.18,Sr. Fernando Camargo,2,2,3,7,Regular
9867,50,2,242.94,Maria Eduarda da Mota,2,1,1,4,Ocasional
9868,61,5,1736.9699999999998,Luiz Otávio Machado,2,3,1,6,Ocasional
9869,144,3,2984.98,Nathan da Mota,1,1,2,4,Ocasional
9870,26,5,6352.16,Isabela Cavalcanti,3,3,3,9,Regular
9871,16,6,9050.79,Ana Carolina Camargo,4,3,4,11,VIP
9872,112,7,15497.79,Bruno Cardoso,1,4,4,9,Regular
9873,61,3,2580.96,Apollo Guerra,2,1,2,5,Ocasional
9874,11,3,1781.83,Vitor Hugo Fonseca,4,1,1,6,Ocasional
9875,131,2,892.08,Murilo Borges,1,1,1,3,Inativo
9876,79,6,5509.17,Clarice Casa Grande,2,3,3,8,Regular
9877,183,3,4922.12,Srta. Mariane Vieira,1,1,3,5,Ocasional
9878,18,4,5501.22,Luísa Brito,4,2,3,9,Regular
9879,73,6,9839.18,Esther Camargo,2,3,4,9,Regular
9880,288,2,2493.71,Enrico Costela,1,1,2,4,Ocasional
9881,2,5,7531.2699999999995,Ayla Cavalcanti,4,3,4,11,VIP
9882,58,4,6023.16,Luiz Otávio da Paz,2,2,3,7,Regular
9883,155,3,525.38,Bento Mendes,1,1,1,3,Inativo
9884,159,5,8217.42,Hellena Moura,1,3,4,8,Regular
9885,89,4,2515.16,Rodrigo Alves,1,2,2,5,Ocasional
9886,38,7,9513.29,Davi Aragão,3,4,4,11,VIP
9887,71,5,6398.52,Dr. Levi Sales,2,3,3,8,Regular
9888,86,9,23788.35,Gabriel Lima,2,4,4,10,VIP
9889,127,5,7101.070000000001,Ana Sophia Porto,1,3,3,7,Regular
9890,92,4,6207.589999999999,Amanda Borges,1,2,3,6,Ocasional
9891,6,4,6618.87,Srta. Juliana Nascimento,4,2,3,9,Regular
9892,118,4,4403.46,Theodoro Teixeira,1,2,3,6,Ocasional
9893,10,4,1617.78,Jade Sousa,4,2,1,7,Regular
9894,155,3,1014.8399999999999,Otávio Santos,1,1,1,3,Inativo
9895,33,5,1893.56,Ana Gonçalves,3,3,1,7,Regular
9896,65,6,7492.23,Dr. Felipe Caldeira,2,3,4,9,Regular
9897,38,3,786.49,Sophia Jesus,3,1,1,5,Ocasional
9898,36,6,7565.01,Josué Barros,3,3,4,10,VIP
9899,24,6,4105.86,Maria Isis Alves,3,3,2,8,Regular
9900,169,5,8184.7699999999995,Liam Ferreira,1,3,4,8,Regular
9901,56,2,4860.030000000001,Maria Vitória Andrade,2,1,3,6,Ocasional
9902,112,5,2336.83,Vitória Santos,1,3,2,6,Ocasional
9903,14,5,3506.32,Kevin da Cruz,4,3,2,9,Regular
9904,227,2,2413.2200000000003,Lavínia da Mota,1,1,2,4,Ocasional
9905,24,6,3748.96,Théo Aparecida,3,3,2,8,Regular
9906,210,2,425.73999999999995,Luan Nascimento,1,1,1,3,Inativo
9907,14,3,2011.92,Vitor Gabriel Gomes,4,1,1,6,Ocasional
9908,65,7,4456.71,Luiz Felipe Albuquerque,2,4,3,9,Regular
9909,38,6,10504.77,Lorenzo Melo,3,3,4,10,VIP
9910,58,4,10584.96,Eduardo Santos,2,2,4,8,Regular
9911,87,8,5584.77,Sofia Duarte,2,4,3,9,Regular
9912,40,2,1068.08,Maitê Ramos,3,1,1,5,Ocasional
9913,3,4,3881.75,Sarah Fogaça,4,2,2,8,Regular
9914,21,8,14860.32,Cecilia Nascimento,3,4,4,11,VIP
9915,13,5,5005.88,Melina da Rosa,4,3,3,10,VIP
9916,60,5,5133.969999999999,Sr. Gael Abreu,2,3,3,8,Regular
9917,165,3,6620.24,Ana Carolina Aparecida,1,1,3,5,Ocasional
9918,5,4,6860.370000000001,Luigi Sales,4,2,3,9,Regular
9919,64,2,1891.1000000000001,Kamilly Vasconcelos,2,1,1,4,Ocasional
9920,46,4,983.56,Sr. Erick Mendes,2,2,1,5,Ocasional
9921,36,7,8628.41,Isabela Martins,3,4,4,11,VIP
9922,12,2,6418.030000000001,Beatriz Cavalcanti,4,1,3,8,Regular
9923,155,6,6921.54,Ravi Lucca Freitas,1,3,3,7,Regular
9924,16,4,4926.75,Ravy Nunes,4,2,3,9,Regular
9925,11,4,6783.81,Anna Liz Guerra,4,2,3,9,Regular
9926,243,3,5737.77,Arthur Miguel da Conceição,1,1,3,5,Ocasional
9927,56,4,2991.9900000000002,Beatriz Ribeiro,2,2,2,6,Ocasional
9928,13,4,8897.7,Dra. Clara Monteiro,4,2,4,10,VIP
9929,101,5,11742.54,Helena Macedo,1,3,4,8,Regular
9930,126,3,3588.41,Thales Campos,1,1,2,4,Ocasional
9931,152,1,120.32,Dr. Eduardo das Neves,1,1,1,3,Inativo
9932,53,4,1307.2,Vitor Hugo Freitas,2,2,1,5,Ocasional
9933,28,3,5374.9,Liz Azevedo,3,1,3,7,Regular
9935,113,6,5148.86,José Melo,1,3,3,7,Regular
9936,15,9,8018.719999999999,Murilo da Conceição,4,4,4,12,VIP
9937,4,3,3002.9,Isabella Mendes,4,1,2,7,Regular
9938,11,5,2754.94,Kevin Lopes,4,3,2,9,Regular
9939,47,5,3798.86,Allana Siqueira,2,3,2,7,Regular
9940,51,11,25478.36,Isis Aparecida,2,4,4,10,VIP
9941,9,5,12085.560000000001,Arthur Gabriel Ribeiro,4,3,4,11,VIP
9943,22,3,2433.96,Mariane Gonçalves,3,1,2,6,Ocasional
9944,9,6,4786.13,Bianca Pereira,4,3,3,10,VIP
9945,136,4,6441.42,Francisco Silva,1,2,3,6,Ocasional
9946,17,8,9175.17,Clara Câmara,4,4,4,12,VIP
9947,121,4,7678.33,Vitória Camargo,1,2,4,7,Regular
9948,40,4,5403.6900000000005,Dra. Maria Sophia Brito,3,2,3,8,Regular
9949,49,6,12604.17,Isabella Silveira,2,3,4,9,Regular
9950,72,5,1881.98,Raquel Ramos,2,3,1,6,Ocasional
9951,18,8,11761.49,Enrico Cavalcante,4,4,4,12,VIP
9952,28,7,7873.9800000000005,Marcela Cunha,3,4,4,11,VIP
9953,33,4,8167.049999999999,Amanda Alves,3,2,4,9,Regular
9954,47,4,6664.9400000000005,Zoe Ramos,2,2,3,7,Regular
9955,56,6,6550.290000000001,Mariah Rezende,2,3,3,8,Regular
9956,38,3,4139.5599999999995,Vitor Gabriel Vasconcelos,3,1,2,6,Ocasional
9957,42,4,4758.05,Bernardo da Mata,3,2,3,8,Regular
9958,289,2,420.29,Alícia da Paz,1,1,1,3,Inativo
9959,218,4,3486.0200000000004,Mariana Nunes,1,2,2,5,Ocasional
9960,2,4,4033.56,Benicio Viana,4,2,2,8,Regular
9961,30,6,2661.58,Ryan Pereira,3,3,2,8,Regular
9962,43,4,6417.57,Sara Cassiano,3,2,3,8,Regular
9963,18,4,11161.46,Luana Cassiano,4,2,4,10,VIP
9964,41,3,4132.47,Srta. Ágatha Moraes,3,1,2,6,Ocasional
9965,18,5,2669.46,Isabelly Farias,4,3,2,9,Regular
9966,111,1,210.33,Dr. Diego Duarte,1,1,1,3,Inativo
9967,26,4,6278.46,Sara Guerra,3,2,3,8,Regular
9968,9,3,8055.55,Dr. Gustavo Henrique Pacheco,4,1,4,9,Regular
9969,24,3,9661.529999999999,Cauã Duarte,3,1,4,8,Regular
9970,12,2,2159.19,Dr. Ryan da Mata,4,1,1,6,Ocasional
9971,61,4,2844.63,Eduardo Teixeira,2,2,2,6,Ocasional
9972,18,3,9758.03,Beatriz Cavalcanti,4,1,4,9,Regular
9973,44,5,6456.01,Srta. Heloisa Dias,2,3,3,8,Regular
9974,29,8,22909.25,Maria Laura Montenegro,3,4,4,11,VIP
9975,7,3,7810.62,Sr. Pietro Santos,4,1,4,9,Regular
9976,83,4,5524.38,Isaac Ferreira,2,2,3,7,Regular
9977,48,6,5134.37,Yasmin Cavalcanti,2,3,3,8,Regular
9978,34,4,7998.370000000001,Alexandre da Cunha,3,2,4,9,Regular
9979,82,7,9268.05,Stella da Cunha,2,4,4,10,VIP
9980,1,4,4441.38,Marcos Vinicius Pacheco,4,2,3,9,Regular
9981,4,2,4422.38,Sr. Vinícius Cavalcanti,4,1,3,8,Regular
9982,195,4,4919.15,Gabriel Nascimento,1,2,3,6,Ocasional
9983,19,4,6557.6,Sra. Maria Sophia Gomes,4,2,3,9,Regular
9984,196,3,953.28,Caio Jesus,1,1,1,3,Inativo
9985,49,5,2984.37,Ágatha Rezende,2,3,2,7,Regular
9986,133,1,659.49,Sra. Ana Laura da Conceição,1,1,1,3,Inativo
9987,57,5,12773.42,Dr. Benjamin Souza,2,3,4,9,Regular
9988,203,6,5963.24,Sr. Benicio Câmara,1,3,3,7,Regular
9989,119,5,9908.24,Mathias Leão,1,3,4,8,Regular
9990,67,6,3895.6,Leandro Oliveira,2,3,2,7,Regular
9991,22,6,5289.889999999999,Lavínia da Rocha,3,3,3,9,Regular
9992,15,4,2420.25,Gael Henrique Cavalcante,4,2,2,8,Regular
9993,84,7,3502.32,Isaac Abreu,2,4,2,8,Regular
9995,13,7,11087.94,Vinícius Pastor,4,4,4,12,VIP
9996,13,8,5716.28,Benício Cunha,4,4,3,11,VIP
9997,10,4,4441.07,Dra. Liz Câmara,4,2,3,9,Regular
9998,89,6,11209.8,Letícia Rezende,1,3,4,8,Regular
9999,172,5,2846.89,Dr. Antônio Porto,1,3,2,6,Ocasional
10000,41,5,9017.69,Lucas Gabriel Novais,3,3,4,10,VIP
